country,year,suicides,male,female,population,rate
Albania,1987,73,48,25,2709600,2.6941245940360203
Albania,1988,63,41,22,2764300,2.279057989364396
Albania,1989,68,53,15,2803100,2.4258856266276623
Albania,1992,47,33,14,2822500,1.6651904340124002
Albania,1993,73,46,27,2807300,2.60036333843907
Albania,1994,50,35,15,2849300,1.7548169725897587
Albania,1995,88,54,34,2903400,3.03092925535579
Albania,1996,89,50,39,2940200,3.0270049656485956
Albania,1997,170,118,52,2977300,5.709871359957008
Albania,1998,154,96,58,3012700,5.111693829455306
Albania,1999,139,91,48,3029700,4.587912994685943
Albania,2000,54,38,16,2796300,1.931123270035404
Albania,2001,119,84,35,2799349,4.250988354792489
Albania,2002,133,91,42,2818839,4.718254572183796
Albania,2003,124,73,51,2843929,4.360165109607167
Albania,2004,146,89,57,2874991,5.078276766779444
Albania,2005,0,0,0,2783320,0.0
Albania,2006,0,0,0,2780176,0.0
Albania,2007,124,77,47,2770344,4.47597843444713
Albania,2008,160,99,61,2757059,5.803285312356391
Albania,2009,0,0,0,2745735,0.0
Albania,2010,96,61,35,2736025,3.5087398689704954
Antigua and Barbuda,1985,0,0,0,62574,0.0
Antigua and Barbuda,1986,0,0,0,61270,0.0
Antigua and Barbuda,1987,0,0,0,60261,0.0
Antigua and Barbuda,1988,0,0,0,59564,0.0
Antigua and Barbuda,1989,0,0,0,59238,0.0
Antigua and Barbuda,1990,1,1,0,59334,1.6853743216368355
Antigua and Barbuda,1991,0,0,0,60394,0.0
Antigua and Barbuda,1992,0,0,0,61741,0.0
Antigua and Barbuda,1993,1,1,0,63315,1.5794045644791912
Antigua and Barbuda,1994,0,0,0,65044,0.0
Antigua and Barbuda,1995,0,0,0,66846,0.0
Antigua and Barbuda,1998,0,0,0,72225,0.0
Antigua and Barbuda,1999,0,0,0,73832,0.0
Antigua and Barbuda,2000,2,2,0,75326,2.6551257202028515
Antigua and Barbuda,2001,2,2,0,76497,2.614481613658052
Antigua and Barbuda,2002,0,0,0,77588,0.0
Antigua and Barbuda,2003,1,1,0,78658,1.2713265020722622
Antigua and Barbuda,2004,2,2,0,79722,2.508717794335315
Antigua and Barbuda,2005,0,0,0,80809,0.0
Antigua and Barbuda,2006,0,0,0,81973,0.0
Antigua and Barbuda,2007,1,1,0,83131,1.2029206914388135
Antigua and Barbuda,2008,0,0,0,84273,0.0
Antigua and Barbuda,2009,0,0,0,85405,0.0
Antigua and Barbuda,2012,0,0,0,88703,0.0
Antigua and Barbuda,2013,0,0,0,89779,0.0
Antigua and Barbuda,2014,0,0,0,90837,0.0
Antigua and Barbuda,2015,1,0,1,91889,1.0882695426003113
Argentina,1985,1988,1450,538,27090800,7.338284583696311
Argentina,1986,2284,1643,641,27244400,8.383374198000324
Argentina,1987,2286,1600,686,27599400,8.28278875627731
Argentina,1988,2354,1689,665,28308000,8.315670481842588
Argentina,1989,2247,1641,606,28702000,7.828722737091492
Argentina,1990,2140,1545,595,29091100,7.356201724926181
Argentina,1991,1951,1452,499,29623000,6.586098639570603
Argentina,1992,2184,1680,504,30045400,7.268999580634639
Argentina,1993,2230,1737,493,30477500,7.3168731031088505
Argentina,1994,2241,1731,510,30911200,7.249799425450969
Argentina,1995,2204,1700,504,31345400,7.031334741301754
Argentina,1996,2229,1697,532,31780700,7.013690699072079
Argentina,1997,2184,1645,539,32333781,6.754545656135916
Argentina,1998,2347,1821,526,32757259,7.164824138674118
Argentina,1999,2423,1930,493,33174862,7.303722921289018
Argentina,2000,2774,2224,550,33585533,8.259508640223158
Argentina,2001,3132,2456,676,34010946,9.208800013971972
Argentina,2002,3162,2459,703,34407507,9.18985499298162
Argentina,2003,3289,2605,684,34785907,9.454978419852615
Argentina,2004,3121,2467,654,35162945,8.87582083923858
Argentina,2005,3058,2394,664,35550617,8.601819765884795
Argentina,2006,3108,2496,612,35918886,8.652829600561667
Argentina,2007,2946,2346,600,36315492,8.112240362873234
Argentina,2008,3059,2448,611,36733520,8.327543889069165
Argentina,2009,2884,2300,584,37158001,7.761450891828115
Argentina,2010,2943,2377,566,37578454,7.831615425158256
Argentina,2011,2912,2329,583,38015739,7.659985249793514
Argentina,2012,3248,2620,628,38441778,8.449140932034933
Argentina,2013,2987,2398,589,38859125,7.6867402444084885
Argentina,2014,3231,2544,687,39276555,8.22628155651635
Argentina,2015,3073,2469,604,39699624,7.740627467907504
Armenia,1990,93,64,29,2983700,3.1169353487280893
Armenia,1991,80,54,26,3230800,2.4761668936486316
Armenia,1992,83,64,19,3308700,2.508538096533382
Armenia,1993,106,71,35,3366600,3.1485771995485057
Armenia,1994,112,76,36,3402500,3.2916972814107273
Armenia,1995,130,95,35,3443200,3.7755576208178443
Armenia,1996,87,63,24,3486300,2.4954823164959983
Armenia,1997,77,62,15,3526700,2.1833442027958148
Armenia,1998,66,48,18,3558000,1.854974704890388
Armenia,1999,67,49,18,3580700,1.8711425140335687
Armenia,2000,61,47,14,3606500,1.6913905448495772
Armenia,2001,60,48,12,3610516,1.6618123282101507
Armenia,2002,74,62,12,3014844,2.4545216933280796
Armenia,2003,59,50,9,3024366,1.9508220896544928
Armenia,2006,78,61,17,2764396,2.8215928542799222
Armenia,2007,71,51,20,2735313,2.595681006159076
Armenia,2008,63,44,19,3045391,2.0686998812303576
Armenia,2009,53,43,10,2689695,1.9704836421973495
Armenia,2010,73,54,19,2676225,2.7277228185223588
Armenia,2011,67,51,16,2670366,2.5090193628888326
Armenia,2012,79,59,20,2814300,2.8070923497850266
Armenia,2013,67,43,24,2810664,2.383778352730885
Armenia,2014,58,43,15,2803029,2.069190151082989
Armenia,2015,74,55,19,2795335,2.647267679902409
Armenia,2016,67,53,14,2400033,2.7916282817777924
Aruba,1995,8,8,0,73581,10.872371943844199
Aruba,1999,9,9,0,81934,10.984450899504479
Aruba,2000,10,6,4,83888,11.920656112912456
Aruba,2001,4,4,0,86045,4.64873031553257
Aruba,2002,9,9,0,88284,10.194372706266142
Aruba,2003,2,2,0,90457,2.2109952795250782
Aruba,2004,8,7,1,92335,8.664103536037256
Aruba,2005,10,5,5,93728,10.669170365312395
Aruba,2006,9,7,2,94508,9.523003343632285
Aruba,2007,8,7,1,94814,8.437572510388762
Aruba,2008,4,3,1,94814,4.218786255194381
Aruba,2009,4,4,0,94795,4.219631837122211
Aruba,2010,7,6,1,95006,7.367955708060544
Aruba,2011,9,7,2,95488,9.425268096514746
Australia,1985,1861,1436,425,14562500,12.7793991416309
Australia,1986,2044,1581,463,14809800,13.801671865926616
Australia,1987,2164,1727,437,15046500,14.382082211810056
Australia,1988,2172,1712,460,15312100,14.18486033920886
Australia,1989,2066,1642,424,15570600,13.268595943637367
Australia,1990,2202,1758,444,15807000,13.930537103814766
Australia,1991,2288,1806,482,16012100,14.289193797190874
Australia,1992,2251,1786,465,16203500,13.892060357330207
Australia,1993,2038,1640,398,16370000,12.449602932193036
Australia,1994,2283,1865,418,16549400,13.795062056630453
Australia,1995,2170,1711,459,16766300,12.942628964052894
Australia,1996,2426,1966,460,17015100,14.257923844114933
Australia,1997,2646,2089,557,17221300,15.364693722309001
Australia,1998,2632,2108,524,17421730,15.107569684526164
Australia,1999,2488,1999,489,17641702,14.10294766343973
Australia,2000,2391,1886,505,17874410,13.37666529972178
Australia,2001,2458,1936,522,18130883,13.556978995452125
Australia,2002,2319,1813,506,18370058,12.62380336523706
Australia,2003,2156,1685,471,18608029,11.586396388354727
Australia,2004,2114,1672,442,18854551,11.212147136253735
Australia,2006,2117,1623,494,19109246,11.078406756603583
Australia,2007,2229,1699,530,19734430,11.294980397204277
Australia,2008,2341,1833,508,20120312,11.635008443209031
Australia,2009,2337,1785,552,20529317,11.383720169550696
Australia,2010,2420,1867,553,20847547,11.608080317554867
Australia,2011,2392,1812,580,20881910,11.45489086007937
Australia,2012,2580,1930,650,21238909,12.147516616790439
Australia,2013,2608,1944,664,21600180,12.073973457628593
Australia,2014,2891,2182,709,21927587,13.184305231578831
Australia,2015,3027,2292,735,22240785,13.610131117224505
Austria,1985,2091,1467,624,7110115,29.408807030547326
Austria,1986,2139,1511,628,7119149,30.04572597089905
Austria,1987,2069,1445,624,7130006,29.01820839982463
Austria,1988,1851,1322,529,7144410,25.908367520900953
Austria,1989,1898,1313,585,7177666,26.443136250697652
Austria,1990,1825,1284,541,7231353,25.237324190922497
Austria,1991,1769,1299,470,7299728,24.23377966959865
Austria,1992,1759,1282,477,7375368,23.849657400145997
Austria,1993,1704,1244,460,7433569,22.92304006325898
Austria,1994,1776,1285,491,7462552,23.79882914048706
Austria,1995,1788,1333,455,7477030,23.91323827776537
Austria,1996,1779,1336,443,7493706,23.739922542998084
Austria,1997,1592,1175,417,7512589,21.19109670447831
Austria,1998,1559,1177,382,7533519,20.694180236354352
Austria,1999,1555,1126,429,7561609,20.56440633203859
Austria,2000,1588,1156,432,7592073,20.91655335769295
Austria,2001,1489,1081,408,7634560,19.503416044932518
Austria,2002,1553,1190,363,7683162,20.213032082364006
Austria,2003,1456,1068,388,7722033,18.85513827770485
Austria,2004,1422,1076,346,7773105,18.293847825289895
Austria,2005,1399,1049,350,7827461,17.872973113503857
Austria,2006,1297,1000,297,7869269,16.481835860484626
Austria,2007,1285,968,317,7897272,16.271441581346064
Austria,2008,1267,963,304,7925258,15.986861247924042
Austria,2009,1278,972,306,7946894,16.081754708191653
Austria,2010,1264,970,294,7968421,15.862615692619654
Austria,2011,1288,975,313,7995146,16.109774605742036
Austria,2012,1276,987,289,8031276,15.88788630847701
Austria,2013,1291,967,324,8079615,15.978484123315283
Austria,2014,1314,990,324,8141165,16.14019615128793
Austria,2015,1251,961,290,8219386,15.220114981824675
Austria,2016,1201,906,295,7484629,16.046219525376607
Azerbaijan,1990,114,89,25,6156800,1.8516112266112266
Azerbaijan,1991,134,102,32,6290600,2.130162464629765
Azerbaijan,1992,144,106,38,6370400,2.2604546025367327
Azerbaijan,1993,119,83,36,6442600,1.8470803712786765
Azerbaijan,1994,47,28,19,6521200,0.7207262467030607
Azerbaijan,1995,49,42,7,6605900,0.7417611529087633
Azerbaijan,1996,69,56,13,6668100,1.0347775228325908
Azerbaijan,1997,107,86,21,6711200,1.5943497437120038
Azerbaijan,1998,56,41,15,7044400,0.7949576968939868
Azerbaijan,1999,54,44,10,7106400,0.7598784194528876
Azerbaijan,2000,62,46,16,7415250,0.8361147634941505
Azerbaijan,2001,317,236,81,7518000,4.216546953977121
Azerbaijan,2002,92,73,19,7605700,1.2096191014633761
Azerbaijan,2003,129,93,36,7674400,1.680913165850099
Azerbaijan,2004,108,78,30,7738250,1.3956643944044196
Azerbaijan,2007,55,41,14,7921100,0.6943480072212193
Bahamas,1985,1,1,0,203700,0.49091801669121254
Bahamas,1987,3,3,0,220900,1.358080579447714
Bahamas,1993,7,6,1,243500,2.8747433264887063
Bahamas,1994,3,3,0,249300,1.203369434416366
Bahamas,1995,2,2,0,254500,0.7858546168958743
Bahamas,1996,3,3,0,252438,1.188410619637297
Bahamas,1997,2,2,0,255956,0.7813843004266359
Bahamas,1998,3,3,0,260125,1.1532916866890919
Bahamas,1999,6,5,1,264791,2.2659380417008133
Bahamas,2000,11,9,2,269738,4.078031274792576
Bahamas,2001,1,1,0,276140,0.36213514883754616
Bahamas,2002,3,3,0,282555,1.0617401921749747
Bahamas,2003,1,1,0,288888,0.34615491124588077
Bahamas,2004,2,2,0,295237,0.6774218678553162
Bahamas,2005,4,3,1,301763,1.325543555704311
Bahamas,2006,2,2,0,308499,0.6483003186396066
Bahamas,2007,5,4,1,314989,1.58735701881653
Bahamas,2008,4,4,0,321447,1.244373100386689
Bahamas,2009,6,5,1,327813,1.830311793614042
Bahamas,2010,10,6,4,333869,2.9951867349169885
Bahamas,2011,4,3,1,338383,1.1820924810052515
Bahamas,2012,5,4,1,343558,1.4553583383300637
Bahamas,2013,5,4,1,348959,1.4328330835427658
Bahrain,1985,11,10,1,365900,3.006285870456409
Bahrain,1987,9,7,2,363900,2.47320692497939
Bahrain,1988,14,13,1,389700,3.59250705671029
Bahrain,1997,0,0,0,529754,0.0
Bahrain,1998,0,0,0,546008,0.0
Bahrain,1999,17,14,3,565762,3.0047970701461035
Bahrain,2000,29,28,1,590594,4.910310636410123
Bahrain,2001,23,20,3,624083,3.6854072294871036
Bahrain,2002,25,18,7,661010,3.782091042495575
Bahrain,2003,34,29,5,702913,4.837013969011812
Bahrain,2004,42,35,7,751559,5.588383613262565
Bahrain,2005,42,35,7,819540,5.1248261219708615
Bahrain,2006,28,17,11,888543,3.151226220903209
Bahrain,2007,40,34,6,964770,4.146065901717508
Bahrain,2008,43,35,8,1024110,4.198767710499848
Bahrain,2009,36,30,6,1092922,3.29392216461925
Bahrain,2010,19,15,4,1139160,1.6678956424031741
Bahrain,2011,18,12,6,1103462,1.6312297115804621
Bahrain,2012,19,18,1,1201778,1.580990831917376
Bahrain,2013,5,5,0,1214492,0.41169476620677614
Bahrain,2014,9,8,1,1213966,0.7413716693877752
Barbados,1985,7,5,2,231000,3.0303030303030303
Barbados,1986,8,7,1,231600,3.4542314335060453
Barbados,1987,6,4,2,233700,2.5673940949935816
Barbados,1988,12,11,1,234800,5.110732538330494
Barbados,1989,16,12,4,236000,6.779661016949152
Barbados,1990,16,13,3,237000,6.751054852320675
Barbados,1991,17,13,4,237000,7.172995780590717
Barbados,1992,14,11,3,240000,5.833333333333333
Barbados,1993,16,15,1,239600,6.677796327212021
Barbados,1994,14,10,4,240300,5.826050769870994
Barbados,1995,17,12,5,241200,7.048092868988391
Barbados,2000,10,8,2,251133,3.981953785444366
Barbados,2001,2,2,0,252406,0.7923741907878576
Barbados,2002,0,0,0,253353,0.0
Barbados,2003,0,0,0,254122,0.0
Barbados,2004,3,3,0,254925,1.1768167107972933
Barbados,2005,1,1,0,255889,0.39079444602933305
Barbados,2006,9,9,0,256883,3.5035405223389637
Barbados,2007,0,0,0,258083,0.0
Barbados,2008,1,0,1,259414,0.385484206712051
Barbados,2009,5,5,0,260718,1.9177808973680375
Barbados,2010,3,3,0,261927,1.1453572942079282
Barbados,2011,0,0,0,263203,0.0
Barbados,2012,0,0,0,264270,0.0
Barbados,2013,0,0,0,265165,0.0
Belarus,1990,2085,1650,435,9408800,22.16010543321146
Belarus,1991,2169,1727,442,9476200,22.888921719676663
Belarus,1992,2424,1954,470,9570900,25.326771776948874
Belarus,1993,2885,2360,525,9641100,29.92397133107218
Belarus,1994,3153,2582,571,9653900,32.66037559949864
Belarus,1995,3203,2689,514,9673600,33.11073436983129
Belarus,1996,3627,3081,546,9684800,37.4504377994383
Belarus,1997,3526,2964,562,9692100,36.380144653893375
Belarus,1998,3556,3006,550,9694800,36.67945702851013
Belarus,1999,3397,2868,529,9563200,35.52158273381295
Belarus,2000,3483,2978,505,9543479,36.49612473606323
Belarus,2001,3303,2813,490,9513587,34.71876590816902
Belarus,2002,3291,2780,511,9469234,34.75465914138356
Belarus,2003,3456,2916,540,9420691,36.68520706177498
Belarus,2007,2659,2203,456,9244456,28.763185199864655
Belarus,2008,2658,2187,471,9205746,28.873271106980354
Belarus,2009,2743,2238,505,9169969,29.912860119810656
Belarus,2010,2459,2069,390,8981193,27.379436117228522
Belarus,2011,2172,1792,380,8947320,24.27542549053795
Belarus,2013,1902,1568,334,8910240,21.346226364273015
Belarus,2014,1741,1465,276,8906977,19.546474634435455
Belgium,1985,2281,1522,759,9269600,24.607318546647104
Belgium,1986,2202,1488,714,9287100,23.71030784636754
Belgium,1987,2238,1543,695,9291300,24.08704917503471
Belgium,1988,1996,1353,643,9319300,21.417917654759478
Belgium,1989,1920,1338,582,9349200,20.536516493389808
Belgium,1990,1895,1303,592,9369700,20.224767068315955
Belgium,1991,1805,1278,527,9396600,19.209075623097714
Belgium,1992,1878,1313,565,9428100,19.919177777070672
Belgium,1993,2142,1552,590,9462900,22.635767048156485
Belgium,1994,2131,1543,588,9497400,22.437719796997072
Belgium,1995,2155,1550,605,9527100,22.61968489886744
Belgium,1996,2013,1458,555,9557545,21.06189403241104
Belgium,1997,2146,1551,595,9576223,22.409670284411714
Belgium,1998,2019,1462,557,9620997,20.98535110238575
Belgium,1999,1857,1361,496,9648277,19.246959845783863
Belgium,2000,2143,1526,617,9674025,22.152103183524954
Belgium,2001,2165,1582,583,9710055,22.296475148698953
Belgium,2002,2076,1497,579,9758570,21.273608735706155
Belgium,2003,2091,1537,554,9804122,21.32776397519329
Belgium,2004,1987,1450,537,9848022,20.17664054771608
Belgium,2005,2029,1477,552,9901014,20.49285053025882
Belgium,2006,1935,1395,540,9962702,19.422441823513342
Belgium,2007,1857,1320,537,10030266,18.513965631619342
Belgium,2008,1999,1452,547,10100850,19.790413678056797
Belgium,2009,2013,1459,554,10173366,19.786961365589324
Belgium,2010,2013,1450,563,10211171,19.713703746612413
Belgium,2011,2088,1488,600,10355126,20.16392654227481
Belgium,2012,2026,1485,541,10442637,19.40122978515867
Belgium,2013,1895,1363,532,10526149,18.002785254132352
Belgium,2014,1899,1338,561,10578848,17.950914882225362
Belgium,2015,1867,1315,552,10624356,17.57282982610899
Belize,1986,3,2,1,146800,2.043596730245232
Belize,1987,4,4,0,144069,2.7764473967335097
Belize,1989,1,1,0,153088,0.6532190635451505
Belize,1990,3,2,1,158000,1.89873417721519
Belize,1991,2,2,0,162200,1.2330456226880395
Belize,1993,1,1,0,170800,0.585480093676815
Belize,1994,8,7,1,170874,4.68181232955277
Belize,1995,14,13,1,180500,7.75623268698061
Belize,1996,8,8,0,180926,4.421697268496512
Belize,1997,1,1,0,187650,0.5329070077271516
Belize,1998,12,11,1,195108,6.1504397564425854
Belize,1999,18,18,0,202699,8.880162210963054
Belize,2000,18,14,4,210109,8.566981899871019
Belize,2001,19,17,2,217279,8.744517417697983
Belize,2002,14,9,5,224136,6.246207659635221
Belize,2003,12,8,4,230890,5.197280090086188
Belize,2004,20,19,1,237791,8.410747252839679
Belize,2005,12,11,1,245020,4.8975593829075175
Belize,2006,11,9,2,252826,4.350818349378624
Belize,2007,8,6,2,260667,3.069049783823806
Belize,2008,11,10,1,268487,4.097032631002619
Belize,2009,15,11,4,276189,5.4310635108566965
Belize,2010,15,13,2,283796,5.285486758093842
Belize,2011,33,28,5,291662,11.314466745753647
Belize,2012,18,16,2,298946,6.021154322185278
Belize,2013,17,16,1,305888,5.557589706036196
Belize,2014,24,18,6,312780,7.673124880107423
Belize,2015,26,22,4,319835,8.129191614426189
Bosnia and Herzegovina,2011,5,5,0,3673312,0.13611694296591198
Bosnia and Herzegovina,2014,313,243,70,3654169,8.5655589547172
Brazil,1985,4228,3162,1066,117478900,3.598944150821977
Brazil,1986,4271,3117,1154,118776400,3.5958321686799732
Brazil,1987,4672,3509,1163,122822467,3.8038643206865403
Brazil,1988,4466,3327,1139,125701294,3.552867164597367
Brazil,1989,4463,3392,1071,128570308,3.4712524761160255
Brazil,1990,4803,3589,1214,131387553,3.65559742177404
Brazil,1991,5156,3961,1195,134281850,3.8396849611470203
Brazil,1992,5207,4033,1174,137007021,3.800535156515811
Brazil,1993,5508,4321,1187,139615477,3.9451213564238294
Brazil,1994,5896,4605,1291,142188450,4.146609657816792
Brazil,1995,6536,5135,1401,144783591,4.514323726091308
Brazil,1996,6698,5300,1398,147353130,4.545543077367953
Brazil,1997,6891,5474,1417,149932627,4.596064337617455
Brazil,1998,6922,5477,1445,152524311,4.538292915153703
Brazil,1999,6507,5281,1226,155122073,4.194760857792302
Brazil,2000,6763,5383,1380,157715991,4.288087693022834
Brazil,2001,7710,6153,1557,160178796,4.813371178042816
Brazil,2002,7697,6003,1694,162761414,4.729007822456003
Brazil,2003,7839,6234,1605,165396911,4.7395081036307865
Brazil,2004,7995,6292,1703,167993068,4.759124941988677
Brazil,2005,8529,6725,1804,170483960,5.002816687270756
Brazil,2006,8618,6817,1801,172974722,4.98223087186115
Brazil,2007,8855,6984,1871,175293192,5.051536741940326
Brazil,2008,9184,7266,1918,177471632,5.1749115599500435
Brazil,2009,9346,7473,1873,179569551,5.204668579919766
Brazil,2010,9429,7356,2073,181629712,5.191331250913397
Brazil,2011,9822,7734,2088,183656441,5.348029149710029
Brazil,2012,10295,8041,2254,185591215,5.5471375625187855
Brazil,2013,10513,8290,2223,187458852,5.608164078589364
Brazil,2014,10631,8398,2233,189285554,5.616382114400553
Brazil,2015,11163,8766,2397,191087085,5.8418390756235565
Bulgaria,1985,1456,1034,422,8392500,17.348823354185285
Bulgaria,1986,1408,975,433,8391500,16.778883393910505
Bulgaria,1987,1492,1063,429,8375400,17.814074551663204
Bulgaria,1988,1452,1025,427,8389800,17.30672960022885
Bulgaria,1989,1460,1041,419,8403200,17.374333587204877
Bulgaria,1990,1323,920,403,8418500,15.715388727207934
Bulgaria,1991,1384,1001,383,8431900,16.41385690057994
Bulgaria,1992,1519,1108,411,8041500,18.889510663433438
Bulgaria,1993,1470,1023,447,8001000,18.372703412073488
Bulgaria,1994,1464,1048,416,7995500,18.310299543493215
Bulgaria,1995,1433,1020,413,7983900,17.948621600971954
Bulgaria,1996,1526,1111,415,7963300,19.162909848931974
Bulgaria,1997,1465,1002,463,7933900,18.46506762122033
Bulgaria,1998,1503,1055,448,7899500,19.02652066586493
Bulgaria,1999,1307,965,342,7866600,16.6145475809117
Bulgaria,2000,1383,1001,382,7829095,17.664876974924944
Bulgaria,2001,1314,951,363,7591926,17.30786100918265
Bulgaria,2002,1317,981,336,7544410,17.45663345443845
Bulgaria,2003,1092,800,292,7493166,14.57327917198151
Bulgaria,2004,1013,746,267,7447563,13.601764765199032
Bulgaria,2005,982,727,255,7404051,13.263009668626
Bulgaria,2006,977,752,225,7358508,13.277148030551846
Bulgaria,2007,902,663,239,7312474,12.3350865931284
Bulgaria,2008,939,694,245,7267511,12.920517079368713
Bulgaria,2009,868,662,206,7219817,12.022465389358207
Bulgaria,2010,859,649,210,7162740,11.992617350343584
Bulgaria,2011,763,605,158,7056527,10.812684483457655
Bulgaria,2012,872,673,199,6959652,12.529362100288923
Bulgaria,2013,721,573,148,6920644,10.418105598265132
Bulgaria,2014,724,552,172,6883874,10.517333699018895
Cabo Verde,2011,42,37,5,452179,9.288357044444789
Canada,1985,3258,2565,693,23499900,13.863888782505459
Canada,1986,3670,2850,820,23499100,15.617619398189717
Canada,1987,3591,2792,799,23798100,15.089439913270388
Canada,1988,3510,2734,776,24080600,14.576048769548931
Canada,1989,3491,2695,796,24368400,14.325930303179529
Canada,1990,3378,2673,705,24704400,13.673677563510953
Canada,1991,3593,2875,718,25390400,14.151017707479994
Canada,1992,3708,2922,786,26454400,14.016571912422886
Canada,1993,3803,3014,789,26944700,14.114092938499965
Canada,1994,3748,2968,780,27246000,13.756147691404243
Canada,1995,3968,3156,812,27618500,14.367181418252258
Canada,1996,3941,3093,848,27706600,14.224047699826036
Canada,1997,3681,2914,767,28085100,13.106593887862248
Canada,1998,3699,2925,774,28372536,13.037255464227801
Canada,1999,4074,3224,850,28681643,14.204207199706097
Canada,2000,3606,2798,808,29008565,12.430811382776087
Canada,2001,3694,2871,823,29262055,12.623857073606073
Canada,2002,3650,2851,799,29642114,12.31356171155674
Canada,2003,3765,2903,862,29958833,12.567245192761682
Canada,2004,3613,2734,879,30283966,11.930405680682643
Canada,2005,3743,2857,886,30597090,12.233189496125286
Canada,2006,3512,2695,817,30902962,11.364606408926107
Canada,2007,3611,2727,884,31242631,11.557925451284817
Canada,2008,3705,2777,928,31588641,11.728899638322522
Canada,2009,3890,2989,901,31937357,12.18009367525309
Canada,2010,3951,2981,970,32286140,12.237449258412433
Canada,2011,3728,2781,947,32615418,11.430176979488659
Canada,2012,3926,2972,954,32961196,11.910975560474201
Canada,2013,4054,3041,1013,33314836,12.168752684239537
Chile,1985,683,572,111,10675400,6.397886730239616
Chile,1986,654,532,122,10931700,5.982601059304591
Chile,1987,693,568,125,11209000,6.182531894013739
Chile,1988,697,580,117,11306000,6.164868211569078
Chile,1989,725,626,99,11501000,6.303799669593949
Chile,1990,743,634,109,11709000,6.345546161072679
Chile,1991,787,654,133,11871000,6.629601549995788
Chile,1992,658,562,96,12125000,5.4268041237113405
Chile,1993,740,624,116,12306400,6.013131378794774
Chile,1994,801,704,97,12526600,6.3943927322657395
Chile,1995,930,807,123,12897643,7.210619800842681
Chile,1996,917,796,121,13125089,6.986619290733953
Chile,1997,910,776,134,13339550,6.821819326738908
Chile,1998,1031,899,132,13543940,7.612260538661571
Chile,1999,1041,903,138,13743882,7.574279232024838
Chile,2000,1473,1266,207,13943575,10.564005285588523
Chile,2001,1625,1392,233,14139590,11.492553885933043
Chile,2002,1603,1357,246,14332840,11.184105871550928
Chile,2003,1654,1402,252,14523758,11.388237121549395
Chile,2004,1735,1472,263,14710993,11.793901336232027
Chile,2005,1682,1403,279,14893574,11.293461193397905
Chile,2006,1795,1498,297,15071596,11.90982030038491
Chile,2007,1848,1496,352,15245435,12.121661336655858
Chile,2008,2088,1674,414,15415661,13.544667335380558
Chile,2009,2148,1724,424,15584149,13.78323577373394
Chile,2010,2001,1618,383,15751851,12.703268968199358
Chile,2011,2027,1657,370,15910783,12.739787853306778
Chile,2012,1841,1510,331,16075247,11.45239012501643
Chile,2013,1738,1420,318,16242244,10.700491877846435
Chile,2014,1789,1475,314,16406867,10.903970879997992
Chile,2015,1838,1460,378,16565725,11.095198067093351
Colombia,1985,1001,783,218,25052400,3.995625169644425
Colombia,1986,958,740,218,25585600,3.7442936651866674
Colombia,1987,951,756,195,28009432,3.395284845476338
Colombia,1988,912,741,171,28649501,3.1833015171887284
Colombia,1989,831,653,178,29289829,2.837162347380041
Colombia,1990,865,665,200,29930973,2.8899828949763844
Colombia,1991,1010,798,212,30584178,3.3023611097215038
Colombia,1992,1086,850,236,29615400,3.667011082072165
Colombia,1993,1085,871,214,30242200,3.587701952900252
Colombia,1994,1198,930,268,30874600,3.8802122132756374
Colombia,1995,1150,889,261,33090899,3.4752757850428906
Colombia,1996,1209,951,258,33703636,3.5871500629783686
Colombia,1997,1242,961,281,34338825,3.616897200180845
Colombia,1998,2052,1552,500,34987039,5.865029046899339
Colombia,1999,2143,1650,493,35629408,6.014694378306818
Colombia,2000,2358,1815,543,36252342,6.504407356633676
Colombia,2001,2412,1855,557,36884428,6.539345004889325
Colombia,2002,2379,1815,564,37478276,6.347677251749787
Colombia,2003,2269,1692,577,38044513,5.964066355639774
Colombia,2004,2244,1743,501,38604716,5.81276132169966
Colombia,2005,2102,1637,465,39172790,5.3659695926687885
Colombia,2006,2177,1717,460,39708676,5.482429079226917
Colombia,2007,2181,1727,454,40275206,5.41524232054828
Colombia,2008,2220,1772,448,40859129,5.433302310482438
Colombia,2009,2249,1802,447,41436173,5.427624795369012
Colombia,2010,2107,1710,397,41989103,5.017968590565033
Colombia,2011,2044,1662,382,42538305,4.805080973489658
Colombia,2012,2119,1732,387,43055864,4.9215131300117445
Colombia,2013,2068,1663,405,43546298,4.748968557556832
Colombia,2014,2126,1755,371,44021800,4.829425421041393
Colombia,2015,2332,1850,482,44490427,5.241577025098006
Costa Rica,1985,128,112,16,2236200,5.723996064752705
Costa Rica,1986,131,118,13,2292900,5.713288848183523
Costa Rica,1987,119,97,22,2400700,4.95688757445745
Costa Rica,1988,138,121,17,2465200,5.597923089404511
Costa Rica,1989,167,136,31,2556000,6.533646322378717
Costa Rica,1990,157,139,18,2627800,5.974579496156481
Costa Rica,1991,125,106,19,2704000,4.622781065088757
Costa Rica,1992,149,126,23,2778400,5.362798733083789
Costa Rica,1993,164,137,27,2853700,5.746925044678838
Costa Rica,1994,162,133,29,2929100,5.530709091529822
Costa Rica,1995,209,173,36,3135200,6.666241388109211
Costa Rica,1996,209,185,24,3192446,6.546704313870932
Costa Rica,1997,187,159,28,3279559,5.701986151186791
Costa Rica,1998,223,200,23,3365726,6.625613612040909
Costa Rica,1999,233,210,23,3449923,6.7537739248093365
Costa Rica,2000,239,211,28,3531421,6.76781386303134
Costa Rica,2001,198,170,28,3606850,5.489554597501975
Costa Rica,2002,275,236,39,3680372,7.472070758064674
Costa Rica,2003,315,262,53,3751871,8.395811050006783
Costa Rica,2004,325,281,44,3820857,8.505945132204634
Costa Rica,2005,272,231,41,3887096,6.997511767139274
Costa Rica,2006,350,295,55,3953916,8.851983704256742
Costa Rica,2007,270,226,44,4015241,6.724378437060191
Costa Rica,2008,261,227,34,4072561,6.408743785544281
Costa Rica,2009,278,236,42,4128459,6.733747386131242
Costa Rica,2010,311,268,43,4184663,7.431900728923691
Costa Rica,2011,316,263,53,4235514,7.460723775201782
Costa Rica,2012,302,260,42,4290210,7.039282459366791
Costa Rica,2013,311,272,39,4347229,7.153982456410739
Costa Rica,2014,268,223,45,4403674,6.085827425009208
Croatia,1995,929,687,242,4497400,20.65637924133944
Croatia,1996,1001,738,263,4220800,23.715883244882487
Croatia,1997,946,692,254,4295100,22.025098367907617
Croatia,1998,1029,745,284,4227900,24.338323990633647
Croatia,1999,989,716,273,4283800,23.086978850553248
Croatia,2000,926,692,234,4118000,22.48664400194269
Croatia,2001,881,656,225,4180633,21.07336377051035
Croatia,2002,874,644,230,4217300,20.72416000758779
Croatia,2003,865,672,193,4225600,20.470465732677017
Croatia,2004,871,645,226,4229600,20.592963873652355
Croatia,2005,874,651,223,4235875,20.63328119927996
Croatia,2006,796,573,223,4234946,18.795989370348522
Croatia,2007,775,577,198,4230855,18.317810466206005
Croatia,2008,793,609,184,4225583,18.76664119483631
Croatia,2009,790,618,172,4216050,18.73791819356981
Croatia,2010,776,584,192,4203963,18.458773305093313
Croatia,2011,702,520,182,4189029,16.75806016143598
Croatia,2012,776,596,180,4054296,19.140191046731665
Croatia,2013,692,546,146,4044457,17.109836994187354
Croatia,2014,722,536,186,4030452,17.913623583657614
Croatia,2015,739,542,197,4001669,18.467294521360962
Croatia,2016,683,515,168,3567043,19.147512379301286
Cuba,1992,2299,1333,966,9915600,23.185687199967727
Cuba,1993,2374,1410,964,10004200,23.73003338597789
Cuba,1994,2278,1441,837,10089300,22.57837511026533
Cuba,1995,2222,1409,813,10168400,21.852012115967113
Cuba,1996,2014,1354,660,10241600,19.664896109982816
Cuba,1997,2029,1401,628,10260492,19.774880190930414
Cuba,1998,2056,1401,655,10307978,19.94571583292087
Cuba,1999,2050,1466,584,10350039,19.80668865112489
Cuba,2000,1845,1310,535,10397209,17.74514679853026
Cuba,2001,1652,1203,449,10433428,15.833722147696808
Cuba,2002,1606,1147,459,10479415,15.325282947569116
Cuba,2003,1499,1126,373,10531074,14.234065775247615
Cuba,2004,1515,1144,371,10578701,14.321229043150003
Cuba,2005,1397,1046,351,10616406,13.158878814544206
Cuba,2006,1376,1103,273,10653638,12.915775812919492
Cuba,2007,1307,1041,266,10678023,12.24009350794618
Cuba,2008,1377,1067,310,10693814,12.876603239966581
Cuba,2009,1477,1141,336,10708230,13.793129209962803
Cuba,2010,1558,1229,329,10725848,14.525658017902174
Cuba,2011,1529,1214,315,10748034,14.225857491704994
Cuba,2012,1495,1199,296,10770535,13.880461834068596
Cuba,2013,1499,1201,298,10792690,13.889030445607165
Cuba,2014,1453,1146,307,10813411,13.437018161984223
Cuba,2015,1511,1211,300,10832068,13.949321588453838
Cyprus,1999,1,1,0,856733,0.1167224794655978
Cyprus,2000,7,7,0,875229,0.7997906833525855
Cyprus,2004,7,5,2,690616,1.0135878693803793
Cyprus,2005,17,12,5,701263,2.424197483683012
Cyprus,2006,19,12,7,713426,2.663205434060435
Cyprus,2007,19,15,4,728566,2.6078625683877643
Cyprus,2008,41,31,10,747034,5.488371345882516
Cyprus,2009,32,25,7,767174,4.171152828432663
Cyprus,2010,38,30,8,787081,4.827965609638652
Cyprus,2011,30,25,5,800820,3.7461601858095452
Cyprus,2012,36,34,2,814305,4.420947924917568
Cyprus,2013,45,40,5,813016,5.534946421718638
Cyprus,2014,44,31,13,804818,5.467074543561401
Cyprus,2015,40,31,9,796037,5.024892059037456
Cyprus,2016,36,31,5,711344,5.060842574056996
Czech Republic,1990,1997,1434,563,9710900,20.564520281333348
Czech Republic,1991,1904,1393,511,9667500,19.69485389190587
Czech Republic,1992,1991,1485,506,9681900,20.5641454673153
Czech Republic,1993,1917,1412,505,9703400,19.755961827812932
Czech Republic,1994,1872,1341,531,9723700,19.251930849368037
Czech Republic,1995,1733,1284,449,9744300,17.78475621645475
Czech Republic,1996,1568,1206,362,9763900,16.05915668943762
Czech Republic,1997,1666,1311,355,9786700,17.023102782347472
Czech Republic,1998,1613,1268,345,9808300,16.445255548871874
Czech Republic,1999,1610,1285,325,9819215,16.39642272829345
Czech Republic,2000,1649,1298,351,9819742,16.792701885650356
Czech Republic,2001,1623,1294,329,9838083,16.497116358949196
Czech Republic,2002,1534,1216,318,9752463,15.729359855043798
Czech Republic,2003,1719,1365,354,9748550,17.63339163260177
Czech Republic,2004,1583,1286,297,9746647,16.241482840201353
Czech Republic,2005,1565,1273,292,9761733,16.031989401881816
Czech Republic,2006,1400,1142,258,9780319,14.314461522165075
Czech Republic,2007,1379,1149,230,9818295,14.045208460328396
Czech Republic,2008,1379,1123,256,9899594,13.9298641944306
Czech Republic,2009,1464,1230,234,9937407,14.732213342977701
Czech Republic,2010,1502,1245,257,9945273,15.102652285161
Czech Republic,2011,1590,1337,253,9906318,16.050363010757376
Czech Republic,2012,1658,1380,278,9923127,16.708442812432008
Czech Republic,2013,1577,1294,283,9936780,15.87033224042396
Czech Republic,2014,1489,1196,293,9963127,14.94510709338544
Czech Republic,2015,1387,1133,254,9989325,13.884822047535744
Czech Republic,2016,1318,1060,258,8929942,14.759334383134853
Denmark,1994,999,680,319,4874900,20.49272805596012
Denmark,1995,924,625,299,4889100,18.899183898877094
Denmark,1996,892,631,261,4917300,18.140036198726943
Denmark,1997,817,560,257,4937300,16.547505721750756
Denmark,1998,763,547,216,4956400,15.394237753207975
Denmark,1999,762,563,199,4976200,15.312889353321811
Denmark,2000,728,533,195,4998610,14.564048805567946
Denmark,2001,727,507,220,5018451,14.486541763584023
Denmark,2002,688,503,185,5041222,13.647484677326252
Denmark,2003,633,480,153,5056783,12.517839899398492
Denmark,2004,661,469,192,5072927,13.029952924613344
Denmark,2005,631,457,174,5089852,12.397217050711886
Denmark,2006,650,472,178,5110460,12.719011595825034
Denmark,2007,581,401,180,5133001,11.318914607653497
Denmark,2008,603,418,185,5162525,11.680330845855467
Denmark,2009,622,477,145,5192790,11.978146622528543
Denmark,2010,563,405,158,5217785,10.79001913647266
Denmark,2011,589,437,152,5244150,11.231562789012518
Denmark,2012,661,494,167,5270539,12.541411798679416
Denmark,2013,610,450,160,5299698,11.510089820212396
Denmark,2014,629,469,160,5339166,11.780866150256426
Denmark,2015,564,390,174,5383060,10.477312160741288
Dominica,1985,0,0,0,66400,0.0
Ecuador,1985,393,279,114,7661800,5.129342974235819
Ecuador,1986,377,246,131,7881300,4.783474807455623
Ecuador,1987,390,259,131,8356800,4.666858127512923
Ecuador,1988,466,324,142,8593200,5.422892519666713
Ecuador,1989,431,267,164,8578619,5.024118683904717
Ecuador,1990,448,295,153,8800933,5.090369396062895
Ecuador,1991,494,305,189,9091700,5.4335272831263675
Ecuador,1992,505,333,172,9253155,5.4575979760416855
Ecuador,1993,574,352,222,9488483,6.049439093688633
Ecuador,1994,512,341,171,9725255,5.2646434463672165
Ecuador,1995,546,366,180,9960563,5.481617856340048
Ecuador,1996,593,396,197,10195848,5.816092982162935
Ecuador,1997,579,390,189,10427773,5.552479901509172
Ecuador,1998,546,373,173,10656446,5.1236594264166495
Ecuador,1999,616,426,190,10883283,5.660056804550612
Ecuador,2000,534,371,163,11109383,4.80674759345321
Ecuador,2001,584,399,185,11328328,5.155217963321683
Ecuador,2002,577,397,180,11548770,4.996203058853887
Ecuador,2003,675,453,222,11771002,5.734431104505801
Ecuador,2004,791,555,236,11994153,6.594880021957366
Ecuador,2005,943,683,260,12217643,7.718346329156941
Ecuador,2006,900,602,298,12449374,7.229279158936024
Ecuador,2007,1005,731,274,12677354,7.927521784119936
Ecuador,2008,928,673,255,12903183,7.1920238595391535
Ecuador,2009,964,719,245,13130161,7.341874939690382
Ecuador,2010,912,658,254,13360285,6.826201686565818
Ecuador,2011,918,654,264,13583553,6.758172916909147
Ecuador,2012,976,711,265,13815861,7.064344379260909
Ecuador,2013,676,490,186,14054613,4.809808708357889
Ecuador,2014,734,567,167,14295145,5.134610386953053
Ecuador,2015,1073,807,266,14534024,7.382676676466201
El Salvador,1990,571,375,196,4510552,12.659204461006103
El Salvador,1991,474,320,154,4576985,10.35616240822288
El Salvador,1992,419,272,147,4591600,9.125359351859919
El Salvador,1993,424,272,152,4694300,9.032230577508892
El Salvador,1995,620,418,202,4836397,12.819460437180817
El Salvador,1996,540,372,168,4892391,11.037547898358902
El Salvador,1997,577,379,198,4949302,11.658209581876394
El Salvador,1998,512,345,167,5006338,10.227036208901596
El Salvador,1999,515,346,169,5062759,10.172319085305068
El Salvador,2000,461,319,142,5118189,9.007092157011005
El Salvador,2001,514,362,152,5175094,9.932186739023484
El Salvador,2002,436,304,132,5230458,8.33579009715784
El Salvador,2003,527,388,139,5283542,9.974369466543466
El Salvador,2004,464,349,115,5333170,8.7002664456599
El Salvador,2005,455,337,118,5378879,8.459011626772046
El Salvador,2006,411,293,118,5429044,7.570393608893205
El Salvador,2007,501,389,112,5467861,9.162632334655179
El Salvador,2008,490,374,116,5499287,8.910246000981582
El Salvador,2009,506,393,113,5528910,9.151894315516078
El Salvador,2010,399,304,95,5560453,7.175674356028186
El Salvador,2011,485,367,118,5585785,8.682754527787948
El Salvador,2012,512,396,116,5618823,9.112228664259401
El Salvador,2013,484,386,98,5657250,8.555393521587344
El Salvador,2014,386,278,108,5696329,6.7762939956593105
Estonia,1995,594,466,128,1356651,43.78428940088497
Estonia,1996,545,433,112,1342202,40.60491639857488
Estonia,1997,522,431,91,1331234,39.21173888287108
Estonia,1998,477,396,81,1321719,36.08936544000654
Estonia,1999,468,375,93,1313198,35.63819012822133
Estonia,2000,377,289,88,1334175,28.257162666067046
Estonia,2001,401,315,86,1325610,30.250224424981706
Estonia,2002,371,299,72,1316690,28.176715855668384
Estonia,2003,342,276,66,1307160,26.163591297163315
Estonia,2004,323,264,59,1297650,24.8911493854275
Estonia,2005,273,220,53,1288495,21.18750945870958
Estonia,2006,247,191,56,1278915,19.313245993674325
Estonia,2007,251,205,46,1270415,19.7573233943239
Estonia,2008,242,189,53,1264005,19.145493886495704
Estonia,2009,269,220,49,1259010,21.36599391585452
Estonia,2010,223,181,42,1254225,17.7799039247344
Estonia,2011,218,178,40,1249427,17.447998162357624
Estonia,2012,237,190,47,1251631,18.935293229394286
Estonia,2013,218,171,47,1243096,17.536859582847985
Estonia,2014,241,193,48,1241852,19.40649932520139
Estonia,2015,195,159,36,1243450,15.682174594877155
Fiji,2001,36,28,8,719459,5.003759769493467
Fiji,2002,42,26,16,723187,5.807626519835119
Fiji,2003,10,6,4,725591,1.378186884897966
Fiji,2004,24,16,8,728408,3.2948567286465824
Fiji,2005,22,16,6,732607,3.0029743095547814
Fiji,2006,24,15,9,737759,3.253094845335672
Fiji,2007,13,10,3,745055,1.744837629436753
Fiji,2008,37,25,12,753658,4.909388608626194
Fiji,2009,26,19,7,762403,3.410269896629473
Fiji,2011,38,30,8,776325,4.894857179660581
Fiji,2012,32,22,10,782939,4.087163878667432
Finland,1987,1363,1065,298,4614100,29.53988860232765
Finland,1988,1402,1107,295,4633600,30.257251381215468
Finland,1989,1413,1118,295,4654300,30.359022839095033
Finland,1990,1512,1193,319,4675100,32.34155419135419
Finland,1991,1493,1190,303,4698500,31.776098754921787
Finland,1992,1451,1156,295,4720900,30.73566480967612
Finland,1993,1397,1106,291,4741000,29.466357308584687
Finland,1994,1387,1080,307,4761600,29.128864247311828
Finland,1995,1388,1080,308,4781300,29.029761780268966
Finland,1996,1247,965,282,4802200,25.967265003540042
Finland,1997,1322,1038,284,4823200,27.409188920218945
Finland,1998,1228,962,266,4844673,25.347427989463895
Finland,1999,1207,954,253,4864255,24.813666224324177
Finland,2000,1165,873,292,4881820,23.864050702401972
Finland,2001,1204,933,271,4898983,24.576529455195086
Finland,2002,1095,824,271,4915614,22.27595576056216
Finland,2003,1075,815,260,4929856,21.805910760882263
Finland,2004,1064,812,252,4944765,21.517706099278733
Finland,2005,994,724,270,4961784,20.033117120777526
Finland,2006,1062,803,259,4979740,21.326414632089225
Finland,2007,995,751,244,4998853,19.90456610746505
Finland,2008,1033,801,232,5020096,20.577295732989967
Finland,2009,1034,761,273,5042316,20.506449813934708
Finland,2010,954,718,236,5063494,18.840745145545743
Finland,2011,912,710,202,5085985,17.93162976296627
Finland,2012,873,655,218,5110450,17.082644385523782
Finland,2013,887,666,221,5135433,17.27215601878167
Finland,2014,789,599,190,5159944,15.29086362177574
Finland,2015,731,558,173,5181797,14.107075209623225
France,1985,12501,8898,3603,51382600,24.32924764414413
France,1986,12529,8872,3657,51637600,24.263327497792307
France,1987,12161,8587,3574,51900800,23.43123805413404
France,1988,11599,8234,3365,52157600,22.23836986364403
France,1989,11715,8343,3372,52417900,22.349235661863602
France,1990,11403,8178,3225,52952900,21.53423136409904
France,1991,11502,8221,3281,53282900,21.586662888093553
France,1992,11644,8442,3202,53622300,21.71484624866893
France,1993,12251,8861,3390,53945400,22.7099993697331
France,1994,12041,8872,3169,54247100,22.19657825026591
France,1995,11819,8605,3214,54528500,21.67490394931091
France,1996,11279,8174,3105,54791600,20.585272195007995
France,1997,11139,8099,3040,55045500,20.2359865929095
France,1998,10534,7771,2763,55280700,19.05547505729848
France,1999,10268,7427,2841,55043393,18.654373286908385
France,2000,10849,7975,2874,55267624,19.62993741145811
France,2001,10449,7660,2789,55511272,18.82320405124206
France,2002,10643,7728,2915,55935517,19.02726670069037
France,2003,10871,8038,2833,56360402,19.288364905559046
France,2004,10804,7855,2949,56813922,19.01646571768096
France,2005,10713,7829,2884,57160687,18.74190210485049
France,2006,10423,7593,2830,57824447,18.025248040850265
France,2007,10127,7419,2708,58167011,17.410212121781537
France,2008,10353,7619,2734,58482967,17.702590225971264
France,2009,10499,7765,2734,58770727,17.864335760216136
France,2010,10379,7641,2738,59056283,17.574759996324186
France,2011,10408,7790,2618,59344643,17.53823003029945
France,2012,9743,7326,2417,59638457,16.336774105339448
France,2013,9600,7225,2375,59910069,16.024017598777927
France,2014,8881,6661,2220,60275954,14.733902013396586
Georgia,1990,196,140,56,4986400,3.930691480827852
Georgia,1991,174,123,51,5018550,3.4671369220193085
Georgia,1992,204,151,53,4988700,4.089241686210836
Georgia,1994,123,90,33,4518900,2.721901347673106
Georgia,1995,138,106,32,4410850,3.128648673158235
Georgia,1996,162,124,38,4310350,3.758395489925412
Georgia,1997,176,141,35,4240600,4.150356081686554
Georgia,1998,148,118,30,4209250,3.516065807447882
Georgia,1999,189,147,42,4187750,4.513163393230255
Georgia,2000,130,102,28,4165600,3.1207989245246783
Georgia,2001,100,73,27,4140950,2.4149047923785605
Georgia,2004,175,147,28,4089850,4.27888553369928
Georgia,2005,87,69,18,4132000,2.1055179090029044
Georgia,2006,72,59,13,4166500,1.7280691227649108
Georgia,2007,104,84,20,4154900,2.503068665912537
Georgia,2009,188,149,39,4158750,4.52058911932672
Georgia,2010,112,96,16,4193800,2.670608994229577
Georgia,2011,99,84,15,4202600,2.3556845762147245
Georgia,2012,104,91,13,4200900,2.4756599776238426
Georgia,2013,157,134,23,4192600,3.7446930305776847
Georgia,2014,194,158,36,3470600,5.589811559960814
Georgia,2015,192,144,48,3458400,5.551700208188758
Germany,1990,13924,9534,4390,74958800,18.575537495264065
Germany,1991,14010,9656,4354,75495900,18.557299138098887
Germany,1992,13458,9326,4132,76131700,17.677261902729086
Germany,1993,12690,8960,3730,76793400,16.524857604950427
Germany,1994,12718,9130,3588,77163400,16.48190722544626
Germany,1995,12888,9222,3666,77547500,16.619491279538348
Germany,1996,12225,8728,3497,77882500,15.696722627034314
Germany,1997,12256,8835,3421,78067900,15.699154197820102
Germany,1998,11654,8581,3073,78071100,14.927418724726564
Germany,1999,11160,8082,3078,78141200,14.281838517964914
Germany,2000,11073,8136,2937,78242066,14.152233659065187
Germany,2001,11167,8196,2971,78421514,14.239714882321707
Germany,2002,11176,8117,3059,78633771,14.212722927913504
Germany,2003,11155,8182,2973,78756461,14.163917294353793
Germany,2004,10741,7946,2795,78811814,13.628667397504643
Germany,2005,10270,7531,2739,78851254,13.024523363953096
Germany,2006,9775,7231,2544,78828994,12.400259731844352
Germany,2007,9409,7012,2397,78776585,11.943904397480544
Germany,2008,9459,7045,2414,78662789,12.024745270600564
Germany,2009,9579,7206,2373,78448602,12.210542642939641
Germany,2010,10030,7471,2559,78349067,12.801684032816881
Germany,2011,10153,7651,2502,78371140,12.955024005010008
Germany,2012,9896,7289,2607,78508115,12.605066367979921
Germany,2013,10091,7456,2635,77270988,13.059235116807358
Germany,2014,10217,7629,2588,77552369,13.174323533559626
Germany,2015,10088,7403,2685,78136683,12.910709301545344
Greece,1985,405,277,128,9275400,4.366388511546671
Greece,1986,393,292,101,9334000,4.210413541889865
Greece,1987,410,296,114,9387400,4.367556511920234
Greece,1988,403,288,115,9450000,4.264550264550264
Greece,1989,383,278,105,9527500,4.019942272369457
Greece,1990,349,271,78,9617000,3.628990329624623
Greece,1991,381,297,84,9721144,3.919291803516129
Greece,1992,351,279,72,9834155,3.569193286052539
Greece,1993,412,308,104,9930405,4.148874089223954
Greece,1994,355,281,74,10018932,3.543291839888723
Greece,1995,370,306,64,10101632,3.662774490300181
Greece,1996,356,294,62,10178479,3.497575620090192
Greece,1997,374,319,55,10248806,3.649205575751946
Greece,1998,403,315,88,10310630,3.908587545086964
Greece,1999,381,296,85,10362363,3.6767675480968967
Greece,2000,382,298,84,10403059,3.6719968616923158
Greece,2001,334,286,48,10441529,3.198765238309447
Greece,2002,323,257,66,10482045,3.081459772401282
Greece,2003,375,306,69,10515665,3.5661082775078894
Greece,2004,353,285,68,10547290,3.346831271350271
Greece,2005,400,321,79,10582816,3.7797123185360118
Greece,2006,394,326,68,10618891,3.710368625122906
Greece,2007,328,268,60,10653591,3.078774095983223
Greece,2008,373,308,65,10686723,3.490312231354738
Greece,2009,391,333,58,10719618,3.6475180365568995
Greece,2010,377,336,41,10735384,3.511751419418253
Greece,2011,477,393,84,10728724,4.446008677266747
Greece,2012,508,417,91,10539802,4.819824888551038
Greece,2013,533,425,108,10431289,5.109627391207357
Greece,2014,565,450,115,10380547,5.44287309714989
Greece,2015,529,422,107,10331286,5.120369332530336
Grenada,1985,1,1,0,85375,1.171303074670571
Grenada,1988,4,3,1,87300,4.581901489117984
Grenada,1989,4,4,0,81805,4.8896766701301875
Grenada,1990,2,2,0,82000,2.4390243902439024
Grenada,1991,0,0,0,82400,0.0
Grenada,1992,0,0,0,83528,0.0
Grenada,1993,3,3,0,85304,3.5168339116571325
Grenada,1994,4,4,0,87036,4.595799439312469
Grenada,1995,1,0,1,88433,1.1307995883889497
Grenada,1996,1,1,0,89772,1.11393307490086
Grenada,2001,0,0,0,91415,0.0
Grenada,2002,0,0,0,91908,0.0
Grenada,2003,4,4,0,92567,4.321194378126114
Grenada,2004,1,1,0,93202,1.0729383489624686
Grenada,2005,6,5,1,93685,6.404440412019
Grenada,2006,1,1,0,94126,1.0624057114931051
Grenada,2007,3,2,1,94418,3.1773602491050434
Grenada,2008,0,0,0,94585,0.0
Grenada,2009,0,0,0,94746,0.0
Grenada,2010,0,0,0,94980,0.0
Grenada,2011,1,1,0,95102,1.051502597211415
Grenada,2012,2,2,0,95426,2.0958648586339153
Grenada,2013,0,0,0,95876,0.0
Grenada,2014,0,0,0,96393,0.0
Grenada,2015,0,0,0,96892,0.0
Grenada,2016,0,0,0,79012,0.0
Guatemala,1986,203,167,36,6924188,2.931751708648003
Guatemala,1987,241,184,57,7108740,3.3901929174509124
Guatemala,1988,174,143,31,7300076,2.383536828931644
Guatemala,1989,152,122,30,7493108,2.0285307511916284
Guatemala,1990,158,131,27,7683992,2.056222859159666
Guatemala,1991,156,124,32,7880665,1.979528377364093
Guatemala,1992,173,135,38,8069672,2.14382938984385
Guatemala,1993,165,135,30,8254958,1.9987987825013767
Guatemala,1994,142,122,20,8443914,1.6816845837131926
Guatemala,1995,211,164,47,8641512,2.4417023317215785
Guatemala,1996,157,124,33,8832326,1.7775611996205756
Guatemala,1997,179,135,44,9044205,1.9791678760045797
Guatemala,1998,201,156,45,9273529,2.167459658561482
Guatemala,1999,234,192,42,9512666,2.459878229720249
Guatemala,2000,182,142,40,9755585,1.865598013855653
Guatemala,2001,202,150,52,10015097,2.0169550030319225
Guatemala,2002,258,194,64,10277166,2.510419701306761
Guatemala,2003,253,200,53,10542980,2.399701033294192
Guatemala,2004,250,184,66,10817808,2.3110042256250063
Guatemala,2005,238,177,61,11104906,2.1431968897350413
Guatemala,2006,298,227,71,11397134,2.6146924305707033
Guatemala,2007,327,263,64,11708397,2.792867375440037
Guatemala,2008,492,371,121,12032885,4.088794998040786
Guatemala,2009,511,366,145,12359945,4.1343226041863455
Guatemala,2010,352,270,82,12682151,2.77555439924978
Guatemala,2011,359,251,108,13017342,2.7578594769961486
Guatemala,2012,420,310,110,13335425,3.1495059212586023
Guatemala,2013,455,331,124,13641878,3.335317908575344
Guatemala,2014,512,356,156,13947190,3.6709903571973994
Guatemala,2015,494,350,144,14258397,3.4646250907447733
Guyana,1988,56,42,14,654894,8.551002146912325
Guyana,1989,94,68,26,654104,14.370803419639689
Guyana,1990,89,64,25,653426,13.620517089922961
Guyana,1991,105,76,29,654620,16.03983990712169
Guyana,1992,78,60,18,656713,11.877334543400238
Guyana,1993,72,57,15,658831,10.928447507782725
Guyana,1994,86,59,27,660582,13.018822795655952
Guyana,1995,99,77,22,661682,14.961869901251658
Guyana,1996,60,51,9,659048,9.104040980323132
Guyana,1997,40,36,4,657584,6.082873062604929
Guyana,1998,35,31,4,657089,5.326523499860749
Guyana,1999,163,121,42,657094,24.806192112544018
Guyana,2001,197,154,43,660426,29.82923143546741
Guyana,2002,176,142,34,662839,26.552450896824116
Guyana,2003,198,153,45,664705,29.787650160597558
Guyana,2004,186,138,48,666308,27.915018279834552
Guyana,2005,169,127,42,667709,25.31042714715542
Guyana,2006,201,151,50,668408,30.07145336381372
Guyana,2007,185,143,42,668788,27.66197958097334
Guyana,2008,168,124,44,669253,25.102614407406463
Guyana,2009,156,109,47,670155,23.278196835060545
Guyana,2010,205,156,49,671825,30.513898708741113
Guyana,2011,192,153,39,675283,28.432523845558084
Guyana,2012,206,156,50,679356,30.32283515564741
Guyana,2013,210,160,50,683867,30.707725332557352
Hungary,1991,3993,2880,1113,9757766,40.921251852114516
Hungary,1992,4000,2939,1061,9754956,41.00479797141064
Hungary,1993,3694,2715,979,9747902,37.89533378566998
Hungary,1994,3625,2727,898,9740817,37.214537548544435
Hungary,1995,3366,2475,891,9737248,34.56828869923001
Hungary,1996,3436,2520,916,9737250,35.28717040232098
Hungary,1997,3208,2383,825,9737781,32.943850349479
Hungary,1998,3245,2468,777,9734373,33.335480364272044
Hungary,1999,3326,2548,778,9553064,34.816054828063535
Hungary,2000,3269,2463,806,9527034,34.31288268730856
Hungary,2001,2978,2282,696,9704598,30.686484901280814
Hungary,2002,2839,2192,647,9680164,29.32801551709248
Hungary,2003,2800,2160,640,9652533,29.007929835619315
Hungary,2004,2742,2087,655,9630044,28.473390152734503
Hungary,2005,2619,2026,593,9608943,27.25585946341861
Hungary,2006,2461,1861,600,9591110,25.659178134751865
Hungary,2007,2450,1879,571,9572938,25.592978874406167
Hungary,2008,2476,1910,566,9552784,25.919145664761185
Hungary,2009,2460,1901,559,9534237,25.801750050895528
Hungary,2010,2489,1942,547,9514005,26.161432540764903
Hungary,2011,2420,1846,574,9495011,25.48706894599701
Hungary,2012,2349,1803,546,9453181,24.848778416492816
Hungary,2013,2092,1587,505,9433840,22.17548739431663
Hungary,2014,1925,1478,447,9412788,20.45090147573705
Hungary,2015,1868,1389,479,9389519,19.894522818474513
Hungary,2016,1761,1315,446,8390370,20.98834735536097
Iceland,1985,32,25,7,220100,14.538845979100408
Iceland,1986,37,25,12,222300,16.644174538911383
Iceland,1987,36,22,14,225600,15.957446808510637
Iceland,1988,35,30,5,229200,15.270506108202444
Iceland,1989,22,16,6,232000,9.482758620689655
Iceland,1990,40,35,5,233300,17.145306472353194
Iceland,1991,37,29,8,235900,15.684612123781264
Iceland,1992,28,23,5,238000,11.764705882352942
Iceland,1993,26,19,7,240500,10.81081081081081
Iceland,1994,25,21,4,242700,10.300782859497321
Iceland,1995,27,22,5,244700,11.03391908459338
Iceland,1996,33,28,5,246500,13.38742393509128
Iceland,1997,33,26,7,248929,13.256792097345027
Iceland,1998,30,23,7,252253,11.892821889135114
Iceland,1999,31,24,7,255820,12.11789539519975
Iceland,2000,50,42,8,259723,19.251279247505995
Iceland,2001,36,28,8,263738,13.649910138091592
Iceland,2002,30,20,10,266455,11.258936781069975
Iceland,2003,26,20,6,268330,9.689561361010695
Iceland,2004,35,26,9,271588,12.887167326980572
Iceland,2005,33,24,9,274929,12.003098981918969
Iceland,2006,32,22,10,282999,11.307460450390284
Iceland,2007,37,30,7,289712,12.771303915612746
Iceland,2008,38,27,11,296836,12.80168173671657
Iceland,2009,36,29,7,296204,12.153785904309192
Iceland,2010,46,36,10,294620,15.613332428212614
Iceland,2011,27,22,5,295475,9.13782891953634
Iceland,2012,37,26,11,297238,12.447937343139166
Iceland,2013,49,35,14,300456,16.308544345927523
Iceland,2014,44,33,11,304472,14.451246748469483
Iceland,2015,40,29,11,308554,12.963695171671732
Iceland,2016,40,36,4,268773,14.882447269629019
Ireland,1985,276,216,60,3208200,8.602954927997008
Ireland,1986,282,215,67,3216700,8.766748531103305
Ireland,1987,245,185,60,3229700,7.585843886429081
Ireland,1988,266,195,71,3233500,8.22638008350085
Ireland,1989,278,213,65,3223200,8.624968974931745
Ireland,1990,334,251,83,3224000,10.359801488833746
Ireland,1991,345,282,63,3252100,10.608529873005136
Ireland,1992,362,304,58,3283400,11.025156849607114
Ireland,1993,326,259,67,3306500,9.859367911689098
Ireland,1994,394,304,90,3326000,11.846061334936861
Ireland,1995,403,320,83,3345900,12.044591888580053
Ireland,1996,408,345,63,3375800,12.086024053557676
Ireland,1997,466,376,90,3414285,13.648538420196322
Ireland,1998,498,425,73,3449415,14.437230660851188
Ireland,1999,424,342,82,3481871,12.177360964837582
Ireland,2000,463,381,82,3523376,13.14080586346731
Ireland,2001,488,409,79,3573974,13.654268329875931
Ireland,2002,449,368,81,3639573,12.336612014651168
Ireland,2003,454,358,96,3694079,12.289937491861977
Ireland,2004,464,390,74,3752679,12.364500134437291
Ireland,2005,451,363,88,3833357,11.765144754323691
Ireland,2006,452,372,80,3937578,11.479137683113834
Ireland,2007,458,362,96,4026707,11.374058256535676
Ireland,2008,506,386,120,4094192,12.35897095202179
Ireland,2009,527,422,105,4117667,12.798509447218533
Ireland,2010,486,386,100,4264857,11.395458276795681
Ireland,2011,554,458,96,4218849,13.131543698293065
Ireland,2012,542,446,96,4220806,12.841149297077383
Ireland,2013,487,391,96,4227378,11.52014321879898
Ireland,2014,486,399,87,4328043,11.229093611130942
Israel,1985,234,159,75,3753500,6.234181430664713
Israel,1986,278,182,96,3813500,7.289891176084962
Israel,1987,271,193,78,3878100,6.987958020680229
Israel,1988,303,214,89,3947300,7.676133052972918
Israel,1989,353,248,105,4021100,8.778692397602645
Israel,1990,304,220,84,4156100,7.314549698034215
Israel,1991,359,262,97,4423200,8.116295894375114
Israel,1992,381,278,103,4588900,8.302643335004031
Israel,1993,371,272,99,4717000,7.865168539325842
Israel,1994,416,304,112,4844900,8.586348531445436
Israel,1995,360,258,102,4977700,7.232255861140688
Israel,1996,306,231,75,5103700,5.995650214550229
Israel,1997,379,301,78,5233500,7.241807585745677
Israel,1998,318,239,79,5360200,5.9326144546845265
Israel,1999,368,297,71,5497047,6.694503430660134
Israel,2000,394,307,87,5643291,6.981741682291414
Israel,2001,398,323,75,5777467,6.888832078140819
Israel,2002,382,291,91,5895508,6.479509484169982
Israel,2003,417,345,72,6003127,6.946379778405488
Israel,2004,411,320,91,6109931,6.726753542715948
Israel,2005,425,304,121,6220861,6.831851732420962
Israel,2006,367,279,88,6334485,5.793683306535575
Israel,2007,326,263,63,6448814,5.055193094420153
Israel,2008,354,294,60,6565602,5.391737117175242
Israel,2009,404,310,94,6731835,6.001335445684572
Israel,2010,480,394,86,6849825,7.007478293241069
Israel,2011,409,322,87,6971495,5.866747376280124
Israel,2012,430,349,81,7095360,6.060298561313309
Israel,2013,372,291,81,7226008,5.148070691313931
Israel,2014,382,294,88,7366252,5.185812269251717
Israel,2015,342,269,73,7516180,4.5501837369514835
Italy,1985,4759,3371,1388,54114700,8.794283253903284
Italy,1986,4691,3293,1398,54267500,8.644216151471875
Italy,1987,4516,3263,1253,54424100,8.297794543226255
Italy,1988,4381,3095,1286,54579700,8.0267938445979
Italy,1989,4342,3124,1218,54697200,7.938249124269616
Italy,1990,4402,3181,1221,54831700,8.028202663787555
Italy,1991,4453,3206,1247,54465500,8.175817719473795
Italy,1992,4543,3339,1204,54154898,8.388899559925308
Italy,1993,4697,3516,1181,54140523,8.675571900182788
Italy,1994,4536,3411,1125,54143049,8.377806724552952
Italy,1995,4569,3430,1139,54141172,8.43904893673155
Italy,1996,4689,3458,1231,54150332,8.659226687659089
Italy,1997,4694,3547,1147,54181477,8.66347737253453
Italy,1998,4504,3448,1056,54250592,8.30221355003831
Italy,1999,4115,3105,1010,54280527,7.58098756115614
Italy,2000,4108,3062,1046,54298946,7.565524384211804
Italy,2001,4030,3050,980,54333844,7.417108202394073
Italy,2002,4069,3145,924,54526842,7.462379721165587
Italy,2003,4075,3078,997,54937570,7.417510457779621
Italy,2004,3986,3046,940,54988156,7.248833730667382
Italy,2005,3742,2803,939,55244690,6.773501670477288
Italy,2006,3700,2841,859,56180672,6.585894878580306
Italy,2007,3757,2893,864,56583578,6.639735649095926
Italy,2008,3904,2997,907,57009825,6.847942437992048
Italy,2009,3974,3093,881,57351830,6.929159889056722
Italy,2010,3989,3128,861,57637843,6.9208002804685105
Italy,2011,4153,3290,863,56610149,7.336140380058
Italy,2012,4257,3324,933,56795085,7.495366896624946
Italy,2013,4290,3322,968,57503331,7.460437378836367
Italy,2014,4147,3215,932,58100676,7.137610584771854
Italy,2015,3988,3105,883,58117697,6.8619374232946635
Jamaica,1985,8,6,2,2035000,0.39312039312039315
Jamaica,1986,1,1,0,2052531,0.04872033601441343
Jamaica,1987,13,10,3,2070760,0.6277888311537794
Jamaica,1988,5,3,2,2090603,0.23916544652428032
Jamaica,1989,0,0,0,2111039,0.0
Jamaica,1990,3,3,0,2131041,0.14077626849976138
Jamaica,1991,1,1,0,2154835,0.04640726552149005
Jamaica,2000,3,3,0,2367841,0.12669769634025257
Jamaica,2001,5,4,1,2391278,0.20909321291794597
Jamaica,2002,2,2,0,2415717,0.0827911547586079
Jamaica,2003,2,1,1,2440426,0.08195290494364509
Jamaica,2004,1,1,0,2464408,0.040577696550246546
Jamaica,2005,51,43,8,2487169,2.0505241099418656
Jamaica,2006,0,0,0,2512597,0.0
Jamaica,2009,36,33,3,2568883,1.4013872955677622
Jamaica,2010,3,3,0,2586652,0.11598003906207717
Jamaica,2011,50,44,6,2601037,1.9223102170403572
Japan,1985,23257,15245,8012,112809200,20.61622633614989
Japan,1986,25484,16350,9134,113679000,22.417508950641718
Japan,1987,23663,15143,8520,114416000,20.681548035239828
Japan,1988,22676,14186,8490,115101000,19.70095828880722
Japan,1989,21013,12846,8167,115766000,18.151270666689705
Japan,1990,20002,12248,7754,116251400,17.205814295569773
Japan,1991,19780,12400,7380,116802000,16.934641530110785
Japan,1992,20756,13396,7360,117311000,17.693140455711738
Japan,1993,20353,13394,6959,117735000,17.287127871915743
Japan,1994,20744,13892,6852,118064000,17.570131454126575
Japan,1995,21249,14079,7170,118349500,17.9544484767574
Japan,1996,21967,14701,7266,118785000,18.49307572504946
Japan,1997,23280,15706,7574,119060000,19.553166470687046
Japan,1998,31458,22078,9380,119338000,26.360421659488175
Japan,1999,31115,22129,8986,119540000,26.02894428643132
Japan,2000,29989,21415,8574,119752660,25.04244999651782
Japan,2001,29132,20868,8264,120066000,24.263321839654857
Japan,2002,29715,21467,8248,120189000,24.723560392381998
Japan,2003,31881,23190,8691,120395000,26.480335562108063
Japan,2004,30034,21764,8270,120500000,24.924481327800827
Japan,2005,30369,22070,8299,120657507,25.16959015239723
Japan,2006,29769,21283,8486,120702000,24.663220162051996
Japan,2007,30665,21867,8798,120704000,25.405123276776244
Japan,2008,30073,21405,8668,120602000,24.935739042470274
Japan,2009,30523,22015,8508,120496000,25.331131323861374
Japan,2010,29411,20905,8506,121127267,24.281072898309514
Japan,2011,28766,19781,8985,120927000,23.78790509977094
Japan,2012,26338,18402,7936,120735000,21.814718184453554
Japan,2013,25991,18081,7910,120514000,21.566788920789286
Japan,2014,24357,16820,7537,120274000,20.251259623858854
Japan,2015,23092,16146,6946,120376310,19.1831764904573
Kazakhstan,1990,3172,2393,779,14773900,21.470295588842486
Kazakhstan,1991,3082,2386,696,14952800,20.611524263014285
Kazakhstan,1992,3356,2571,785,15150100,22.151668965881413
Kazakhstan,1993,4019,3190,829,15331400,26.21417483073953
Kazakhstan,1994,4024,3244,780,15229600,26.422230393444348
Kazakhstan,1995,4706,3906,800,14989600,31.395100603084806
Kazakhstan,1996,4773,3996,777,14487700,32.945187987051085
Kazakhstan,1997,4642,3881,761,14394600,32.248204187681495
Kazakhstan,1998,4313,3584,729,13844200,31.153840597506534
Kazakhstan,1999,3991,3328,663,13773400,28.976142419446177
Kazakhstan,2000,4428,3682,746,13772422,32.15120768155376
Kazakhstan,2001,4377,3719,658,13772696,31.78027018094351
Kazakhstan,2002,4240,3562,678,13777476,30.77486761726168
Kazakhstan,2003,4321,3633,688,13811863,31.284700695337044
Kazakhstan,2004,4394,3702,692,13873328,31.67228512149356
Kazakhstan,2005,3903,3269,634,13947770,27.98296788662274
Kazakhstan,2006,4076,3401,675,14037676,29.036145299264636
Kazakhstan,2007,4141,3420,721,14125606,29.315556444091673
Kazakhstan,2008,3997,3230,767,14216053,28.11610226833004
Kazakhstan,2009,3838,3120,718,14370635,26.707240146312255
Kazakhstan,2010,3609,2964,645,14713167,24.529049388211252
Kazakhstan,2011,3401,2793,608,14853350,22.897191542648628
Kazakhstan,2012,3240,2677,563,15023549,21.566142593870463
Kazakhstan,2013,3512,2837,675,15215382,23.081904877577177
Kazakhstan,2014,3119,2556,563,15428844,20.215383602297102
Kazakhstan,2015,2872,2342,530,15646752,18.35524714650044
Kiribati,1991,10,8,2,61855,16.166841807452915
Kiribati,1992,4,3,1,62856,6.363752068219422
Kiribati,1993,12,10,2,63848,18.794637263500814
Kiribati,1994,10,8,2,64871,15.41520864484901
Kiribati,1995,2,2,0,65923,3.033842513235138
Kiribati,1996,6,3,3,67126,8.938414325298691
Kiribati,1997,5,5,0,68328,7.3176443039456744
Kiribati,1998,4,4,0,69570,5.749604714675866
Kiribati,1999,0,0,0,70938,0.0
Kiribati,2000,0,0,0,72440,0.0
Kiribati,2001,0,0,0,73851,0.0
Kuwait,1985,17,14,3,1468000,1.1580381471389645
Kuwait,1986,16,12,4,1535300,1.0421416009900346
Kuwait,1987,16,11,5,1606300,0.9960779430990474
Kuwait,1993,18,12,6,1273600,1.4133165829145728
Kuwait,1994,30,18,12,1448000,2.0718232044198897
Kuwait,1995,26,21,5,1511100,1.7206008867712264
Kuwait,1996,30,19,11,1568700,1.9124115509657678
Kuwait,1997,33,16,17,1617500,2.0401854714064913
Kuwait,1998,35,20,15,1825766,1.9170036028713426
Kuwait,1999,46,33,13,1898700,2.4227102754516245
Kuwait,2000,34,20,14,1973153,1.723130441481223
Kuwait,2001,30,25,5,2038530,1.4716486880251947
Kuwait,2002,45,34,11,2158603,2.0846816204739826
Kuwait,2003,44,30,14,1950622,2.255690748899582
Kuwait,2004,45,28,17,1996086,2.2544118840570997
Kuwait,2005,52,41,11,2062968,2.5206401650437624
Kuwait,2006,45,34,11,2165713,2.077837645154275
Kuwait,2007,51,37,14,3074918,1.658580814187565
Kuwait,2008,47,33,14,3369394,1.394909589083378
Kuwait,2009,61,40,21,3165654,1.9269320020444431
Kuwait,2010,39,26,13,3281614,1.188439591006133
Kuwait,2011,41,26,15,3333698,1.2298654527194726
Kuwait,2012,56,37,19,3496698,1.6015109111510346
Kuwait,2013,41,28,13,3574090,1.1471451474361307
Kuwait,2014,68,50,18,3715284,1.8302773085449189
Kyrgyzstan,1990,547,400,147,3737300,14.636234714901132
Kyrgyzstan,1991,543,410,133,3796500,14.302647175029634
Kyrgyzstan,1992,491,385,106,3839300,12.788789623108379
Kyrgyzstan,1993,563,442,121,3841200,14.656878058939917
Kyrgyzstan,1994,581,493,88,3851100,15.086598634156474
Kyrgyzstan,1995,605,467,138,3905400,15.491370922312695
Kyrgyzstan,1996,480,392,88,3978800,12.063938876043029
Kyrgyzstan,1997,496,409,87,4059900,12.217049681026626
Kyrgyzstan,1998,509,421,88,4139700,12.295576974176873
Kyrgyzstan,1999,556,457,99,4298100,12.935948442334986
Kyrgyzstan,2000,510,414,96,4369202,11.67261206966398
Kyrgyzstan,2001,560,483,77,4425784,12.653125412356319
Kyrgyzstan,2002,567,467,100,4473163,12.67559442837205
Kyrgyzstan,2003,479,397,82,4520843,10.595369049533462
Kyrgyzstan,2004,438,363,75,4572278,9.579470014727889
Kyrgyzstan,2005,470,386,84,4614533,10.185212674825383
Kyrgyzstan,2006,463,366,97,4646475,9.964543013790022
Kyrgyzstan,2007,482,366,116,4668640,10.324205764419617
Kyrgyzstan,2008,473,379,94,4690924,10.083301285631574
Kyrgyzstan,2009,458,362,96,4800134,9.541400302574885
Kyrgyzstan,2010,500,395,105,4837556,10.335797663117491
Kyrgyzstan,2011,471,363,108,4870538,9.670389595564187
Kyrgyzstan,2012,524,402,122,4932360,10.62371765240169
Kyrgyzstan,2013,446,349,97,5012200,8.89828817684849
Kyrgyzstan,2014,461,358,103,5096430,9.04554756957321
Kyrgyzstan,2015,417,327,90,5195827,8.0256713705056
Latvia,1995,1024,825,199,2374700,43.12123636669895
Latvia,1996,922,741,181,2363400,39.011593467039006
Latvia,1997,886,706,180,2354700,37.62687391175097
Latvia,1998,839,678,161,2344100,35.791988396399475
Latvia,1999,763,593,170,2333400,32.699065740978824
Latvia,2000,770,618,152,2272107,33.88924905385178
Latvia,2001,708,571,137,2242227,31.575750358906568
Latvia,2002,670,521,149,2214484,30.25535519787002
Latvia,2003,604,482,122,2190211,27.5772516894491
Latvia,2004,563,457,106,2163477,26.022925133939488
Latvia,2005,564,445,119,2137831,26.38187957794606
Latvia,2006,487,407,80,2115215,23.023664261079844
Latvia,2007,453,358,95,2093878,21.63449828500037
Latvia,2008,527,427,100,2067529,25.489364357162586
Latvia,2009,516,416,100,2030316,25.414763022110847
Latvia,2010,438,376,62,1987906,22.033234971874926
Latvia,2011,440,365,75,1953611,22.52239570723138
Latvia,2012,444,371,73,1931521,22.98706563376738
Latvia,2013,383,322,61,1912464,20.026520760652225
Latvia,2014,382,311,71,1894041,20.16851799934637
Latvia,2015,387,306,81,1875522,20.634255423290156
Lithuania,1995,1694,1388,306,3387149,50.01256218725541
Lithuania,1996,1722,1388,334,3375163,51.019758156865315
Lithuania,1997,1632,1348,284,3364273,48.50973746779765
Lithuania,1998,1553,1285,268,3350973,46.344748226858286
Lithuania,1999,1550,1285,265,3333452,46.498344658930144
Lithuania,2000,1631,1317,314,3315125,49.19874816183402
Lithuania,2001,1533,1255,278,3294138,46.537212466508684
Lithuania,2002,1551,1309,242,3274488,47.36618365985766
Lithuania,2003,1455,1199,256,3254127,44.71245283297179
Lithuania,2004,1380,1124,256,3222969,42.81766284441457
Lithuania,2005,1319,1084,235,3174728,41.54686637721405
Lithuania,2006,1049,853,196,3125767,33.55976309174676
Lithuania,2007,1025,848,177,3087867,33.19443486393682
Lithuania,2008,1111,918,193,3053756,36.381426675870635
Lithuania,2009,1138,952,186,3016497,37.725878726217864
Lithuania,2010,1018,829,189,2949737,34.511551368816946
Lithuania,2011,1018,817,201,2879805,35.34961568578428
Lithuania,2012,927,753,174,2837770,32.6664951705036
Lithuania,2013,1085,887,198,2806627,38.65850360592982
Lithuania,2014,930,769,161,2781577,33.43427127848699
Lithuania,2015,896,727,169,2753926,32.5353695052082
Lithuania,2016,822,693,129,2445296,33.61556228775576
Luxembourg,1985,55,39,16,344800,15.951276102088167
Luxembourg,1986,51,37,14,346000,14.739884393063585
Luxembourg,1987,74,45,29,349400,21.179164281625642
Luxembourg,1988,69,52,17,352300,19.585580471189328
Luxembourg,1989,73,54,19,355400,20.540236353404612
Luxembourg,1990,68,47,21,358800,18.9520624303233
Luxembourg,1991,77,54,23,362900,21.217966381923397
Luxembourg,1992,59,29,30,367300,16.063163626463382
Luxembourg,1993,64,48,16,372000,17.204301075268816
Luxembourg,1994,74,61,13,377000,19.628647214854112
Luxembourg,1995,63,45,18,382100,16.487830410887202
Luxembourg,1996,72,53,19,387700,18.571060098013927
Luxembourg,1997,81,60,21,392600,20.631686194600103
Luxembourg,1998,64,48,16,397915,16.0838370003644
Luxembourg,1999,70,49,21,403890,17.331451632870337
Luxembourg,2000,62,47,15,410164,15.115904857569166
Luxembourg,2001,73,50,23,413930,17.635832145531854
Luxembourg,2002,85,63,22,418106,20.32977283272663
Luxembourg,2003,48,40,8,423654,11.330000424875015
Luxembourg,2004,62,45,17,430128,14.414313878659376
Luxembourg,2005,49,39,10,437338,11.204148736217753
Luxembourg,2006,65,47,18,444821,14.61261945816407
Luxembourg,2007,78,53,25,452012,17.256179039494526
Luxembourg,2008,43,35,8,460371,9.340292937652459
Luxembourg,2009,48,36,12,469209,10.229982800841416
Luxembourg,2010,54,43,11,477979,11.297567466353124
Luxembourg,2011,55,37,18,488918,11.249330153522678
Luxembourg,2012,51,39,12,501044,10.178746776730186
Luxembourg,2013,40,24,16,512689,7.8020008231110864
Luxembourg,2014,67,52,15,524940,12.763363432011278
Luxembourg,2015,64,45,19,537748,11.901485454153246
Macau,1994,27,15,12,346542,7.791263396644562
Maldives,2000,0,0,0,247387,0.0
Maldives,2001,3,2,1,255503,1.1741545109059384
Maldives,2002,3,2,1,263747,1.1374536961557857
Maldives,2003,4,3,1,272110,1.4699937525265518
Maldives,2004,1,0,1,280526,0.35647319678033407
Maldives,2005,1,1,0,288936,0.3460974056538472
Maldives,2007,5,3,2,305536,1.6364683703393381
Maldives,2008,0,0,0,313924,0.0
Maldives,2010,1,1,0,331559,0.30160544578792914
Maldives,2011,2,2,0,341018,0.5864793060776851
Malta,1985,2,2,0,307200,0.6510416666666667
Malta,1986,1,0,1,315800,0.31665611146295125
Malta,1987,1,1,0,317400,0.315059861373661
Malta,1988,9,8,1,320800,2.805486284289277
Malta,1989,23,18,5,324000,7.098765432098765
Malta,1990,8,8,0,327400,2.4434941967012827
Malta,1991,10,9,1,330800,3.022974607013301
Malta,1992,18,12,6,334300,5.384385282680228
Malta,1993,16,9,7,337700,4.737933076695292
Malta,1994,15,12,3,341700,4.389815627743635
Malta,1995,17,11,6,344900,4.928964917367352
Malta,1996,10,9,1,348200,2.871912693854107
Malta,1997,15,11,4,350400,4.280821917808219
Malta,1998,12,11,1,353400,3.395585738539898
Malta,1999,27,22,5,355600,7.592800899887514
Malta,2000,23,17,6,362676,6.341748557941524
Malta,2001,30,23,7,370541,8.096270048388707
Malta,2002,19,11,8,374456,5.074027389065738
Malta,2003,20,17,3,377785,5.29401643792104
Malta,2004,24,14,10,380918,6.300568626318524
Malta,2005,19,16,3,384111,4.946486822819445
Malta,2006,26,21,5,386038,6.735088255560333
Malta,2007,26,25,1,387581,6.708275173447615
Malta,2008,14,12,2,390195,3.587949614936122
Malta,2009,36,33,3,393102,9.157928476578599
Malta,2010,31,29,2,394949,7.849114695821486
Malta,2011,20,20,0,396423,5.045115949377307
Malta,2012,25,19,6,399138,6.263497837840547
Malta,2013,22,21,1,402728,5.462744085337995
Malta,2014,32,27,5,406525,7.871594612877438
Malta,2015,34,27,7,410637,8.279818915489837
Mauritius,1985,104,68,36,883400,11.772696400271679
Mauritius,1986,28,20,8,898100,3.1176929072486357
Mauritius,1987,140,87,53,911300,15.362668715022496
Mauritius,1988,167,111,56,925000,18.054054054054056
Mauritius,1989,144,107,37,932900,15.43573802122414
Mauritius,1990,147,91,56,941100,15.620019126554032
Mauritius,1991,137,94,43,938100,14.603986781792987
Mauritius,1992,146,100,46,948300,15.395971738901192
Mauritius,1993,138,93,45,958300,14.400500886987372
Mauritius,1994,129,107,22,972800,13.260690789473683
Mauritius,1995,147,115,32,981900,14.97097464100214
Mauritius,1996,153,117,36,995000,15.376884422110551
Mauritius,1997,122,102,20,1011700,12.058910744291786
Mauritius,1998,155,114,41,1026300,15.102796453278769
Mauritius,1999,174,120,54,1042400,16.69224865694551
Mauritius,2000,137,107,30,1056073,12.972588069195973
Mauritius,2001,113,76,37,1068947,10.571150861548794
Mauritius,2002,131,102,29,1079755,12.132381882927145
Mauritius,2003,88,64,24,1092234,8.05688158398292
Mauritius,2004,97,75,22,1103091,8.79347216140826
Mauritius,2005,102,79,23,1113942,9.156670634557276
Mauritius,2006,118,89,29,1125301,10.486083279051561
Mauritius,2007,127,97,30,1135233,11.187130747608641
Mauritius,2008,84,72,12,1146258,7.328193129295499
Mauritius,2009,115,92,23,1159551,9.917631910972437
Mauritius,2010,98,76,22,1164931,8.412515419368185
Mauritius,2011,118,95,23,1173352,10.056658189528804
Mauritius,2012,115,89,26,1180547,9.741247065978737
Mauritius,2013,98,83,15,1147390,8.541123767855742
Mauritius,2014,120,96,24,1151424,10.421877605469401
Mauritius,2015,104,78,26,1154848,9.005514145584527
Mauritius,2016,98,83,15,992432,9.874731971560772
Mexico,1985,1544,1279,265,67566000,2.2851730160139714
Mexico,1986,1714,1445,269,69123500,2.4796198109181393
Mexico,1987,1701,1416,285,67948100,2.5033812571653953
Mexico,1988,1703,1423,280,69646000,2.4452229848088907
Mexico,1989,1865,1580,285,71359000,2.6135455934079794
Mexico,1990,1926,1648,278,73076900,2.6355797796567724
Mexico,1991,2103,1789,314,74796300,2.8116364044745525
Mexico,1992,2237,1899,338,75285800,2.9713438656426576
Mexico,1993,2342,2011,331,76826800,3.048415396710523
Mexico,1994,2588,2195,393,78374100,3.3021112842125135
Mexico,1995,2877,2434,443,79927100,3.5995300717779077
Mexico,1996,3008,2514,494,83802294,3.5894005479134017
Mexico,1997,3350,2811,539,85340880,3.9254340944222745
Mexico,1998,3312,2802,510,86825678,3.8145397494045485
Mexico,1999,3327,2819,508,88271977,3.7690330647063677
Mexico,2000,3456,2919,537,89694793,3.853066476222315
Mexico,2001,3760,3088,672,91052714,4.129476030774876
Mexico,2002,3826,3170,656,92394316,4.140947371697626
Mexico,2003,4070,3376,694,93758859,4.340923133460914
Mexico,2004,4056,3381,675,95193068,4.260814453422176
Mexico,2005,4274,3544,730,96730008,4.418484075799932
Mexico,2006,4230,3521,709,98468839,4.295775235046693
Mexico,2007,4285,3523,762,100294297,4.272426377344267
Mexico,2008,4642,3782,860,102170587,4.5433819422022115
Mexico,2009,5023,4057,966,104044342,4.827749307117537
Mexico,2010,4858,3958,900,105875861,4.588392438197031
Mexico,2011,5558,4487,1071,107655100,5.1627837417827855
Mexico,2012,5381,4330,1051,109368765,4.920051899644291
Mexico,2013,5711,4668,1043,111036708,5.143344127241236
Mexico,2014,6178,4950,1228,112692589,5.482170615496286
Mexico,2015,6234,4986,1248,114357884,5.451307581032192
Mongolia,2016,423,371,52,2167589,19.514769635756593
Montenegro,2000,0,0,0,578668,0.0
Montenegro,2001,0,0,0,578668,0.0
Montenegro,2002,0,0,0,578668,0.0
Montenegro,2003,0,0,0,579688,0.0
Montenegro,2004,0,0,0,581623,0.0
Montenegro,2005,118,82,36,583232,20.232086030944803
Montenegro,2006,0,0,0,584885,0.0
Montenegro,2007,121,89,32,587244,20.604723079333294
Montenegro,2008,126,80,46,589953,21.35763357419998
Montenegro,2009,107,77,30,592234,18.067182904054818
Netherlands,1985,1638,1048,590,13618300,12.027933001916539
Netherlands,1986,1604,998,606,13695500,11.711876163703407
Netherlands,1987,1616,995,621,13777000,11.729694418233287
Netherlands,1988,1523,965,558,13855700,10.991866163384023
Netherlands,1989,1520,953,567,13929300,10.912249718219869
Netherlands,1990,1450,909,541,14014300,10.346574570260376
Netherlands,1991,1611,1033,578,14114800,11.413551732932808
Netherlands,1992,1587,1041,546,14216900,11.16277106823569
Netherlands,1993,1555,1020,535,14313600,10.863793874357254
Netherlands,1994,1584,1084,500,14397700,11.001757225112344
Netherlands,1995,1511,1000,511,14474000,10.43940859472157
Netherlands,1996,1577,1043,534,14553700,10.835732494142382
Netherlands,1997,1572,1042,530,14639900,10.737778263512729
Netherlands,1998,1519,1002,517,14734600,10.309068451128637
Netherlands,1999,1519,1016,503,14832000,10.241370010787486
Netherlands,2000,1501,1000,501,14933235,10.051405472424428
Netherlands,2001,1474,1010,464,15038337,9.80161569726759
Netherlands,2002,1570,1063,507,15130318,10.376516871621602
Netherlands,2003,1502,1018,484,15203397,9.879371037933167
Netherlands,2004,1514,1022,492,15265861,9.917553946023745
Netherlands,2005,1574,1074,500,15320595,10.273752422800811
Netherlands,2006,1525,1046,479,15368697,9.922767037439803
Netherlands,2007,1354,944,410,15425404,8.777727960966208
Netherlands,2008,1439,991,448,15506963,9.279702285998876
Netherlands,2009,1530,1068,462,15602176,9.806324451153479
Netherlands,2010,1604,1127,477,15691409,10.222154046204519
Netherlands,2011,1650,1137,513,15772162,10.461470025479068
Netherlands,2012,1756,1186,570,15839503,11.086206429583049
Netherlands,2013,1856,1307,549,15899508,11.673317186921759
Netherlands,2014,1839,1250,589,15899508,11.566395639412239
Netherlands,2015,1873,1282,591,16057342,11.664446083293237
Netherlands,2016,1886,1273,613,14239554,13.244796852485688
New Zealand,1985,338,255,83,3025800,11.170599510873156
New Zealand,1986,414,301,113,3026100,13.680975513036582
New Zealand,1987,463,363,100,3047100,15.194775360178529
New Zealand,1988,484,381,103,3055200,15.841843414506416
New Zealand,1989,465,372,93,3063800,15.17723088974476
New Zealand,1990,455,363,92,3089400,14.727778856735934
New Zealand,1991,474,380,94,3203900,14.794469240613003
New Zealand,1992,493,397,96,3235600,15.236741253554209
New Zealand,1993,443,349,94,3273200,13.534156177441035
New Zealand,1994,512,409,103,3319500,15.424009640006025
New Zealand,1995,545,429,116,3373800,16.153891754105164
New Zealand,1996,540,428,112,3432500,15.731973780043699
New Zealand,1997,562,441,121,3470200,16.19503198662901
New Zealand,1998,574,442,132,3502800,16.38689048760991
New Zealand,1999,516,385,131,3549300,14.538077930859606
New Zealand,2000,458,375,83,3573690,12.815884981629631
New Zealand,2001,508,389,119,3599090,14.11467898829982
New Zealand,2002,467,354,113,3659190,12.76238730429412
New Zealand,2003,519,378,141,3729420,13.916373055327638
New Zealand,2004,495,382,113,3802510,13.01771724466208
New Zealand,2005,514,382,132,3849280,13.35314656247402
New Zealand,2006,527,388,139,3898600,13.517673010824398
New Zealand,2007,494,376,118,3935450,12.552567050781995
New Zealand,2008,520,381,139,3968450,13.103352694376897
New Zealand,2009,512,394,118,4009980,12.768143482012379
New Zealand,2010,536,387,149,4055470,13.21671717458149
New Zealand,2011,493,377,116,4090460,12.052434200554462
New Zealand,2012,549,404,145,4120870,13.322429486977265
New Zealand,2013,513,366,147,4129770,12.421999288095948
Nicaragua,2010,351,274,77,5107427,6.872344920446245
Nicaragua,2011,369,276,93,5177921,7.126412318766548
Nicaragua,2012,316,234,82,5251443,6.017393695409052
Nicaragua,2013,351,276,75,5326935,6.589154926801247
Nicaragua,2014,311,241,70,5402424,5.756675151746697
Nicaragua,2015,315,230,85,5476483,5.751866663331192
Norway,1986,579,419,160,3911700,14.801748600352788
Norway,1987,649,486,163,3929500,16.516096195444714
Norway,1988,708,510,198,3946600,17.939492221152385
Norway,1989,660,481,179,3955800,16.68436220233581
Norway,1990,659,488,171,3961300,16.63595284376341
Norway,1991,675,499,176,3972600,16.99139102854554
Norway,1992,616,449,167,3989800,15.43937039450599
Norway,1993,590,449,141,4010500,14.71138262062087
Norway,1994,531,379,152,4033300,13.165398061141001
Norway,1995,548,411,137,4055900,13.51118124214108
Norway,1996,517,389,128,4078000,12.677783227072094
Norway,1997,533,387,146,4102100,12.993344872138662
Norway,1998,548,399,149,4129400,13.270693078897661
Norway,1999,583,430,153,4159745,14.015282186768662
Norway,2000,541,409,132,4168315,12.978865560784154
Norway,2001,549,411,138,4215103,13.024592756096352
Norway,2002,494,362,132,4243689,11.640815337787478
Norway,2003,502,374,128,4273124,11.747845370272428
Norway,2004,529,359,170,4301960,12.296720564579866
Norway,2005,533,360,173,4335092,12.29501011743234
Norway,2006,532,391,141,4372103,12.168057339911709
Norway,2007,485,336,149,4417369,10.979386145916267
Norway,2008,505,347,158,4472089,11.29226184899272
Norway,2009,573,416,157,4527536,12.655890532952139
Norway,2010,548,384,164,4582885,11.957533300530125
Norway,2011,598,434,164,4643300,12.878771563327806
Norway,2012,515,369,146,4706585,10.9421162052741
Norway,2013,554,378,176,4767605,11.620090171060733
Norway,2014,548,401,147,4827178,11.35238849696448
Norway,2015,590,400,190,4882909,12.082961202021172
Oman,2009,13,13,0,2607549,0.49855247207243275
Oman,2010,13,13,0,2748440,0.472995590225728
Oman,2014,7,7,0,3631098,0.1927791538537379
Panama,1985,56,44,12,1899700,2.9478338685055534
Panama,1986,82,67,15,1939900,4.227022011443889
Panama,1987,85,64,21,1980800,4.291195476575121
Panama,1988,87,66,21,2064310,4.214483289815968
Panama,1989,70,61,9,2112479,3.313642407806184
Panama,1996,113,98,15,2472851,4.569624291960979
Panama,1997,145,124,21,2526210,5.739823688450287
Panama,1998,148,124,24,2579433,5.737695067094203
Panama,1999,143,124,19,2633348,5.430349501850876
Panama,2000,143,124,19,2688510,5.318931303956466
Panama,2001,162,139,23,2742982,5.905981154816182
Panama,2002,160,130,30,2800046,5.7141918382769425
Panama,2003,195,174,21,2858964,6.820652516086246
Panama,2004,186,152,34,2918453,6.3732395210750346
Panama,2005,172,148,24,2977595,5.776473966405773
Panama,2006,185,172,13,3037959,6.089614770969588
Panama,2007,171,150,21,3097138,5.521226370926966
Panama,2008,186,154,32,3155636,5.894215936185289
Panama,2009,177,149,28,3214513,5.506277311679872
Panama,2010,151,130,21,3274415,4.611510758410281
Panama,2011,144,125,19,3334191,4.318888749924644
Panama,2012,135,117,18,3395244,3.9761501677051783
Panama,2013,130,117,13,3457387,3.7600650433405343
Panama,2014,147,127,20,3520213,4.175883675220789
Panama,2015,110,91,19,3583382,3.069725750701432
Paraguay,1985,63,36,27,3077314,2.0472398981709374
Paraguay,1986,56,33,23,3167535,1.7679362658976143
Paraguay,1987,62,39,23,3261975,1.900688999762414
Paraguay,1989,67,48,19,3459176,1.9368774528962966
Paraguay,1990,99,49,50,3560229,2.780720004246918
Paraguay,1991,75,48,27,3662812,2.047607138995941
Paraguay,1994,108,81,27,3972517,2.7186793662557016
Paraguay,1995,118,83,35,4076758,2.894456820836557
Paraguay,1996,99,69,30,4181422,2.3676156101919394
Paraguay,1997,126,85,41,4284973,2.9405086099725715
Paraguay,1998,138,93,45,4388094,3.144873377826455
Paraguay,1999,161,106,55,4492220,3.583974070726723
Paraguay,2000,154,107,47,4598158,3.349167210000178
Paraguay,2001,152,98,54,4701314,3.233138650173122
Paraguay,2002,177,111,66,4809921,3.6798941188431162
Paraguay,2003,174,129,45,4920489,3.5362338987039705
Paraguay,2004,234,157,77,5027301,4.654585034793023
Paraguay,2005,239,155,84,5126457,4.6620892362893125
Paraguay,2006,251,182,69,5223460,4.805244033648195
Paraguay,2007,227,159,68,5307169,4.277233304611178
Paraguay,2008,222,160,62,5382169,4.1247311260571715
Paraguay,2009,283,213,70,5456220,5.186741003845152
Paraguay,2010,223,160,63,5534703,4.029123152588314
Paraguay,2011,298,222,76,5610499,5.311470512694147
Paraguay,2012,275,187,88,5695283,4.828557246409002
Paraguay,2013,323,247,76,5786207,5.582240663011192
Paraguay,2014,379,269,110,5877594,6.448216736304005
Philippines,1992,347,244,103,55304684,0.6274332929919643
Philippines,1993,846,506,340,56781569,1.4899200830466661
Philippines,1997,814,595,219,62772694,1.296742179011785
Philippines,1998,883,665,218,64252614,1.3742631544920492
Philippines,1999,1043,788,255,65740201,1.5865482370520896
Philippines,2000,1403,1045,358,67243482,2.086447575692169
Philippines,2001,1204,927,277,68738092,1.751576112994233
Philippines,2002,1301,999,302,70256443,1.8517874581267941
Philippines,2003,1544,1142,402,71781489,2.150972376736292
Philippines,2006,1788,1386,402,76435755,2.3392193875758798
Philippines,2007,1698,1292,406,78008654,2.176681576892738
Philippines,2008,1820,1411,409,79595888,2.2865502800848203
Philippines,2009,2074,1549,525,81193855,2.5543805008396263
Philippines,2010,2116,1629,487,82760992,2.55676007363469
Philippines,2011,2449,1879,570,84201767,2.9084900320441016
Poland,1990,4970,4091,879,35164800,14.133451633451633
Poland,1991,5316,4448,868,35396300,15.01851888474219
Poland,1992,5713,4732,981,35605400,16.045318968471076
Poland,1993,5624,4641,983,35792600,15.71274509256103
Poland,1994,5519,4628,891,35960000,15.347608453837596
Poland,1995,5499,4562,937,36104900,15.230619666582653
Poland,1996,5446,4537,909,36243300,15.026225536857845
Poland,1999,5779,4895,884,36575200,15.800323716616726
Poland,2000,5841,4869,972,36233344,16.12051043370438
Poland,2001,5855,5005,850,36295390,16.131525243288472
Poland,2002,5925,4933,992,36347498,16.300984458407566
Poland,2003,5836,4948,888,36353775,16.05335346879382
Poland,2004,6072,5162,910,36371596,16.694345774653385
Poland,2005,6045,5138,907,36371365,16.620217580505983
Poland,2006,5805,4947,858,36348232,15.970515429746348
Poland,2007,5284,4472,812,36310843,14.552127032688281
Poland,2008,5682,4870,812,36262711,15.6689884548345
Poland,2009,6477,5531,946,36223402,17.88070595909241
Poland,2010,6357,5517,840,36027791,17.64471210571861
Poland,2011,6113,5353,760,36008237,16.976671198870413
Poland,2012,6368,5558,810,36013446,17.68228455560737
Poland,2013,6218,5378,840,36023694,17.260861698414384
Poland,2014,5934,5123,811,36059630,16.4560756724348
Poland,2015,5420,4697,723,36086575,15.01943589825302
Portugal,1985,983,693,290,9313930,10.554084044007203
Portugal,1986,941,672,269,9349248,10.064980627318903
Portugal,1987,960,709,251,9378989,10.235644801374647
Portugal,1988,819,623,196,9400481,8.712320146171244
Portugal,1989,747,549,198,9415270,7.933920110628797
Portugal,1990,870,642,228,9420814,9.234870787174016
Portugal,1991,942,708,234,9410507,10.010087660526686
Portugal,1992,866,630,236,9401557,9.21124022329493
Portugal,1993,780,586,194,9410082,8.28898196636331
Portugal,1994,762,587,175,9436009,8.07544799925477
Portugal,1995,809,582,227,9473844,8.53930041491078
Portugal,1996,653,491,162,9515960,6.862155788801129
Portugal,1997,628,483,145,9564579,6.565892759106282
Portugal,1998,556,416,140,9617110,5.781362592296438
Portugal,1999,545,407,138,9671357,5.6351967981328785
Portugal,2000,524,417,107,9740085,5.379829847480797
Portugal,2001,761,586,175,9809536,7.757757349583099
Portugal,2002,1210,947,263,9859832,12.272014371035937
Portugal,2003,1156,889,267,9895009,11.682657388184285
Portugal,2007,1020,751,269,10005713,10.194176067212801
Portugal,2008,1038,794,244,10030640,10.348292830766532
Portugal,2009,1025,803,222,10049918,10.199088191565345
Portugal,2010,1099,834,265,10066628,10.917260476894548
Portugal,2011,1017,794,223,10062815,10.106515920246968
Portugal,2012,1076,859,217,10029396,10.7284626113078
Portugal,2013,1052,811,241,9985074,10.535725624066481
Portugal,2014,1222,924,298,9944433,12.288282298246667
Puerto Rico,1985,269,234,35,3082500,8.72668288726683
Puerto Rico,1986,310,272,38,3143200,9.862560447951132
Puerto Rico,1987,272,234,38,3189400,8.528249827553772
Puerto Rico,1988,314,284,30,3235600,9.704537025590307
Puerto Rico,1989,327,292,35,3283800,9.957975516170292
Puerto Rico,1990,371,333,38,3204000,11.579275905118601
Puerto Rico,1991,355,319,36,3237200,10.966267144445817
Puerto Rico,1992,314,279,35,3287900,9.55016880075428
Puerto Rico,1993,345,311,34,3312472,10.415182377390662
Puerto Rico,1994,355,320,35,3343624,10.617222510665075
Puerto Rico,1995,289,255,34,3375154,8.562572255962246
Puerto Rico,1996,331,297,34,3401823,9.730077079260148
Puerto Rico,1997,273,254,19,3432757,7.952791298655861
Puerto Rico,1998,321,290,31,3464834,9.26451310510114
Puerto Rico,1999,289,257,32,3492721,8.274351143420846
Puerto Rico,2000,305,278,27,3511947,8.68464131150043
Puerto Rico,2001,289,255,34,3522212,8.205071131436721
Puerto Rico,2002,239,202,37,3523951,6.782160137867978
Puerto Rico,2003,262,240,22,3519026,7.445241950471522
Puerto Rico,2004,279,256,23,3511462,7.945408493670159
Puerto Rico,2005,289,248,41,3504599,8.246307209469613
Puerto Rico,2006,265,243,22,3499036,7.5735145337172876
Puerto Rico,2007,271,228,43,3493631,7.756972616741723
Puerto Rico,2008,300,253,47,3488811,8.598918084126655
Puerto Rico,2009,330,301,29,3484474,9.470582934468732
Puerto Rico,2010,286,241,45,3480379,8.217495853181507
Puerto Rico,2011,258,216,42,3475298,7.4238237987073346
Puerto Rico,2012,248,204,44,3472672,7.141474921904517
Puerto Rico,2013,241,204,37,3471665,6.941914038364876
Puerto Rico,2014,220,188,32,3470956,6.338311404696573
Puerto Rico,2015,226,201,25,3469521,6.513867476230869
Qatar,1995,0,0,0,463449,0.0
Qatar,2001,23,18,5,539483,4.263341013525912
Qatar,2004,21,20,1,697191,3.0120870751343607
Qatar,2005,17,16,1,796618,2.134021576213442
Qatar,2006,29,24,5,940090,3.0848110287312918
Qatar,2007,41,37,4,1115479,3.67555104130154
Qatar,2008,33,31,2,1310465,2.5181901080914026
Qatar,2009,44,41,3,1506649,2.920388225791143
Qatar,2010,47,46,1,1689592,2.7817366559500756
Qatar,2011,50,45,5,1854081,2.696753809569269
Qatar,2012,43,38,5,2003149,2.146620146579211
Qatar,2013,37,36,1,2135349,1.7327378334876407
Qatar,2014,55,52,3,2251682,2.4426184514509597
Qatar,2015,66,57,9,2354147,2.8035632439265687
Qatar,2016,68,63,5,2213121,3.0725839210779706
Republic of Korea,1985,3689,2691,998,36716700,10.047199230867697
Republic of Korea,1986,3458,2568,890,37540400,9.211409574751467
Republic of Korea,1987,3301,2400,901,38114900,8.660655019428098
Republic of Korea,1988,2949,2118,831,38700500,7.620056588416171
Republic of Korea,1989,3023,2124,899,39171500,7.717345519063605
Republic of Korea,1990,3159,2197,962,39589500,7.979388474216647
Republic of Korea,1991,3069,2139,930,39993700,7.673708609105934
Republic of Korea,1992,3533,2467,1066,40371200,8.75128804692454
Republic of Korea,1993,4124,2848,1276,40754800,10.119053461187393
Republic of Korea,1994,4212,2862,1350,41145300,10.236892184526544
Republic of Korea,1995,4841,3319,1522,42076400,11.505261857002976
Republic of Korea,1996,5857,4042,1815,42507100,13.778874588010002
Republic of Korea,1997,6024,4162,1862,42956100,14.023619462660717
Republic of Korea,1998,8569,6200,2369,43395700,19.746196051682542
Republic of Korea,1999,7075,4968,2107,43817300,16.14659050192504
Republic of Korea,2000,6444,4481,1963,44271743,14.555559739312725
Republic of Korea,2001,6911,4852,2059,44710865,15.457093035440042
Republic of Korea,2002,8611,5939,2672,45110041,19.088876465441473
Republic of Korea,2003,10898,7514,3384,45455888,23.974891877593503
Republic of Korea,2004,11492,7879,3613,45779970,25.102681369166472
Republic of Korea,2005,12011,8026,3985,46151884,26.02493974027149
Republic of Korea,2006,10653,7227,3426,46513964,22.902799683983073
Republic of Korea,2007,12174,7747,4427,46814207,26.004926239592184
Republic of Korea,2008,12858,8260,4598,47101747,27.29835052614927
Republic of Korea,2009,15402,9927,5475,47380017,32.50737541947273
Republic of Korea,2010,15558,10321,5237,47598615,32.68582499721893
Republic of Korea,2011,15906,10866,5040,47798017,33.277531157830246
Republic of Korea,2012,14159,9621,4538,48020985,29.48502618178282
Republic of Korea,2013,14426,10059,4367,48248224,29.899546147025017
Republic of Korea,2014,13834,9735,4099,48465917,28.543770254052966
Republic of Korea,2015,13510,9556,3954,48671752,27.757373517189187
Romania,1989,2529,1886,643,21344500,11.848485558340556
Romania,1990,2079,1523,556,21401900,9.714090805021984
Romania,1991,2161,1638,523,21458000,10.070836051822164
Romania,1992,2650,2077,573,21227100,12.484041626034646
Romania,1993,2774,2191,583,21307600,13.018828962435938
Romania,1994,2887,2298,589,21386000,13.499485644814365
Romania,1995,2793,2256,537,21451300,13.020189918559714
Romania,1996,2828,2335,493,21397300,13.216620788604171
Romania,1997,2859,2375,484,21369000,13.379194159764143
Romania,1998,2838,2350,488,21338400,13.29996625801372
Romania,1999,2736,2235,501,21310800,12.83856072977082
Romania,2000,2836,2325,511,21290400,13.320557622214707
Romania,2001,2720,2278,442,21272887,12.786228780324926
Romania,2002,3067,2539,528,20700580,14.816009986193622
Romania,2003,2894,2386,508,20656841,14.009886603668004
Romania,2004,2720,2276,444,20610767,13.196985827844252
Romania,2005,2603,2133,470,20569960,12.654375604036177
Romania,2006,2721,2240,481,20526561,13.255995487992362
Romania,2007,2430,1984,446,20475026,11.868116797507364
Romania,2008,2472,2026,446,20433803,12.09760121500633
Romania,2009,2586,2197,389,20390882,12.682139007032655
Romania,2010,2766,2304,462,20348649,13.593040009683197
Romania,2011,2536,2142,394,20291701,12.497720127060811
Romania,2012,2495,2142,353,19041594,13.10289464211872
Romania,2013,2407,2043,364,19003345,12.666191136349942
Romania,2014,2209,1887,322,18952235,11.655617398159109
Romania,2015,2228,1886,342,18863927,11.810902364072973
Romania,2016,1953,1643,310,16644905,11.733320196180152
Russian Federation,1989,37921,29373,8548,135443800,27.997590144399375
Russian Federation,1990,39028,30286,8742,136398200,28.61328082042138
Russian Federation,1991,39281,30821,8460,137283000,28.613156763765357
Russian Federation,1992,45923,36794,9129,138118900,33.24888918171228
Russian Federation,1993,55846,45750,10096,137692800,40.558402472750934
Russian Federation,1994,61420,51032,10388,138476200,44.35419227275156
Russian Federation,1995,60548,49915,10633,139087100,43.53243399280019
Russian Federation,1996,57511,47826,9685,139272600,41.29383669149567
Russian Federation,1997,54746,45252,9494,139283200,39.305530028029224
Russian Federation,1998,51518,42547,8971,139122100,37.030780875216806
Russian Federation,1999,56974,47065,9909,138717800,41.071873977240124
Russian Federation,2000,56619,47520,9099,138205695,40.967197480537976
Russian Federation,2001,56958,47952,9006,137521509,41.41752109482743
Russian Federation,2002,55024,45967,9057,136590900,40.283796358322554
Russian Federation,2003,51445,42995,8450,137019868,37.54564994910081
Russian Federation,2004,49096,40894,8202,137071699,35.81775111724558
Russian Federation,2005,45802,38338,7464,136162191,33.6378253490354
Russian Federation,2006,42614,35387,7227,135357462,31.482564293352365
Russian Federation,2007,41149,33808,7341,134778964,30.530728816108127
Russian Federation,2008,38211,31286,6925,134385949,28.43377621271998
Russian Federation,2009,37408,30923,6485,134085433,27.898630867679714
Russian Federation,2010,33356,27561,5795,134865987,24.732700024654843
Russian Federation,2011,31038,25470,5568,134745874,23.034471541592435
Russian Federation,2012,29643,24189,5454,134668522,22.011825450939458
Russian Federation,2013,28690,23714,4976,134713962,21.296975884355625
Russian Federation,2014,26541,21886,4655,134713962,19.701744055304378
Russian Federation,2015,25432,20861,4571,137018943,18.560937227489777
Saint Kitts and Nevis,1990,0,0,0,39100,0.0
Saint Kitts and Nevis,1991,0,0,0,39100,0.0
Saint Kitts and Nevis,1992,0,0,0,39100,0.0
Saint Lucia,1986,5,5,0,110000,4.545454545454545
Saint Lucia,1987,11,10,1,111300,9.883198562443846
Saint Lucia,1988,10,6,4,113000,8.849557522123893
Saint Lucia,1989,8,5,3,118566,6.747296864193783
Saint Lucia,1990,3,2,1,120537,2.4888623410239177
Saint Lucia,1991,6,6,0,122496,4.898119122257053
Saint Lucia,1992,11,11,0,124223,8.855042946958292
Saint Lucia,1993,8,8,0,125846,6.356975986523211
Saint Lucia,1994,6,4,2,127557,4.703779486817658
Saint Lucia,1995,10,9,1,129466,7.72403565414858
Saint Lucia,1996,7,6,1,131621,5.318300271233314
Saint Lucia,1997,9,9,0,133967,6.718072361103854
Saint Lucia,1998,8,5,3,136400,5.865102639296188
Saint Lucia,1999,8,7,1,138813,5.763148984605188
Saint Lucia,2000,14,11,3,141100,9.922041105598867
Saint Lucia,2001,7,7,0,143166,4.889429054384421
Saint Lucia,2002,12,8,4,145168,8.266284580623829
Saint Lucia,2003,10,6,4,147127,6.796848980812495
Saint Lucia,2004,8,8,0,149121,5.364770890753147
Saint Lucia,2005,4,4,0,151169,2.646045154760566
Saint Lucia,2006,2,2,0,153460,1.3032712107389548
Saint Lucia,2008,0,0,0,157876,0.0
Saint Lucia,2009,13,13,0,159820,8.134150919784757
Saint Lucia,2010,4,3,1,161503,2.476734178312477
Saint Lucia,2011,8,8,0,162892,4.911229526311913
Saint Lucia,2012,10,9,1,163940,6.09979260705136
Saint Lucia,2013,14,13,1,164790,8.495661144486922
Saint Lucia,2014,14,11,3,165596,8.45431049059156
Saint Vincent and Grenadines,1985,2,2,0,89800,2.2271714922048997
Saint Vincent and Grenadines,1986,0,0,0,90800,0.0
Saint Vincent and Grenadines,1987,0,0,0,92036,0.0
Saint Vincent and Grenadines,1990,5,5,0,94141,5.3111821629258245
Saint Vincent and Grenadines,1995,7,7,0,95974,7.2936420280492635
Saint Vincent and Grenadines,1996,8,7,1,96095,8.325094958114367
Saint Vincent and Grenadines,1997,3,3,0,96255,3.116721209287829
Saint Vincent and Grenadines,1998,10,10,0,96449,10.368173853539176
Saint Vincent and Grenadines,1999,6,6,0,96685,6.205719604902519
Saint Vincent and Grenadines,2000,5,5,0,96956,5.156978423202277
Saint Vincent and Grenadines,2001,8,7,1,97341,8.218530732168356
Saint Vincent and Grenadines,2002,7,6,1,97799,7.157537398132905
Saint Vincent and Grenadines,2003,4,4,0,98292,4.069507182680177
Saint Vincent and Grenadines,2004,4,4,0,98740,4.051043143609479
Saint Vincent and Grenadines,2005,8,7,1,99118,8.07118787707581
Saint Vincent and Grenadines,2006,6,5,1,99463,6.032393955541257
Saint Vincent and Grenadines,2007,11,11,0,99689,11.034316725014795
Saint Vincent and Grenadines,2008,4,3,1,99826,4.006972131508825
Saint Vincent and Grenadines,2009,1,1,0,99927,1.0007305332893013
Saint Vincent and Grenadines,2010,5,5,0,100050,4.997501249375312
Saint Vincent and Grenadines,2011,5,4,1,100037,4.998150684246829
Saint Vincent and Grenadines,2012,10,7,3,100167,9.98332784250302
Saint Vincent and Grenadines,2013,0,0,0,100398,0.0
Saint Vincent and Grenadines,2014,2,2,0,100676,1.9865707815169455
Saint Vincent and Grenadines,2015,3,2,1,100948,2.9718270792883463
San Marino,1999,2,2,0,25192,7.939028262940616
San Marino,2000,1,1,0,25369,3.941818755173637
San Marino,2005,1,1,0,28264,3.5380696292103027
Serbia,1998,1460,1015,445,7179002,20.3370886371114
Serbia,1999,1571,1091,480,7162831,21.93266880092522
Serbia,2000,1543,1069,474,7149140,21.583015579496276
Serbia,2001,1442,1025,417,7142410,20.18926384791688
Serbia,2002,1446,1051,395,7138113,20.2574545961937
Serbia,2003,1378,997,381,7111975,19.37577114655212
Serbia,2004,1345,978,367,7086364,18.980114484663787
Serbia,2005,1437,1006,431,7058982,20.357042984385
Serbia,2006,1443,1021,422,7031811,20.52102936213729
Serbia,2007,1353,968,385,7009610,19.302072440549477
Serbia,2008,1289,903,386,6988532,18.444503080189087
Serbia,2009,1373,997,376,6968240,19.703684144059334
Serbia,2010,1207,903,304,6944871,17.37973246731293
Serbia,2011,1256,909,347,6900027,18.202827322269897
Serbia,2012,1243,932,311,6867174,18.100604411654636
Serbia,2013,1197,901,296,6832840,17.518337909273452
Serbia,2014,1134,857,277,6801810,16.672032885364338
Serbia,2015,1062,793,269,6766406,15.695185893367913
Seychelles,1985,8,7,1,57300,13.961605584642234
Seychelles,1986,1,1,0,57400,1.7421602787456445
Seychelles,1987,3,3,0,58300,5.145797598627787
Seychelles,2001,6,5,1,75363,7.961466502129693
Seychelles,2002,5,5,0,76904,6.501612399875168
Seychelles,2003,8,6,2,78402,10.203821331088491
Seychelles,2004,6,6,0,79735,7.524926318429799
Seychelles,2005,5,4,1,80900,6.180469715698393
Seychelles,2006,8,8,0,81691,9.793000452926272
Seychelles,2007,6,5,1,82331,7.287655925471572
Seychelles,2008,4,4,0,82900,4.8250904704463204
Seychelles,2009,4,4,0,83429,4.7944959186853495
Seychelles,2010,6,6,0,83885,7.15264946057102
Seychelles,2011,5,5,0,80717,6.194481955474064
Seychelles,2012,3,3,0,81224,3.693489608982567
Seychelles,2013,9,9,0,82541,10.903672114464328
Seychelles,2014,4,2,2,83845,4.770707853777805
Seychelles,2015,7,6,1,85949,8.144364681380818
Singapore,1985,324,190,134,2350500,13.784301212507977
Singapore,1986,326,191,135,2379300,13.701508847139914
Singapore,1987,301,171,130,2407800,12.501038292216961
Singapore,1988,366,220,146,2393400,15.292053146151918
Singapore,1989,394,215,179,2431100,16.206655423470856
Singapore,1990,354,201,153,2511800,14.093478780157655
Singapore,1991,296,177,119,2559300,11.56566248583597
Singapore,1992,277,160,117,2604000,10.63748079877112
Singapore,1993,270,168,102,2655800,10.166428194894195
Singapore,1994,316,190,126,2712200,11.651058181550033
Singapore,1995,364,226,138,2765300,13.16312877445485
Singapore,1996,239,152,87,2823100,8.465870851191951
Singapore,1997,303,196,107,2880000,10.520833333333334
Singapore,1998,328,200,128,2940200,11.155703693626284
Singapore,1999,277,187,90,2997100,9.242267525274432
Singapore,2000,309,204,105,3047600,10.139125869536684
Singapore,2001,305,190,115,3103000,9.829197550757332
Singapore,2002,321,192,129,3165200,10.141539239226589
Singapore,2003,320,201,119,3226200,9.91878990763127
Singapore,2004,335,205,130,3281400,10.209057109770221
Singapore,2005,359,240,119,3342400,10.740785064624221
Singapore,2006,372,231,141,3411900,10.903015914886135
Singapore,2007,328,197,131,3389600,9.676658012744868
Singapore,2008,319,207,112,3448900,9.249325872017165
Singapore,2009,349,235,114,3536100,9.869630383756116
Singapore,2010,296,197,99,3576800,8.275553567434578
Singapore,2011,308,197,111,3600900,8.553417201255241
Singapore,2012,392,243,149,3631600,10.79414032382421
Singapore,2013,357,245,112,3661456,9.750219584777202
Singapore,2014,355,250,105,3689370,9.622239027259397
Singapore,2015,329,218,111,3719115,8.846190558775406
Slovakia,1992,796,654,142,4909228,16.214362013742285
Slovakia,1993,738,622,116,4935260,14.953619464830625
Slovakia,1994,691,583,108,4974858,13.88984369001085
Slovakia,1995,735,609,126,5005232,14.684633998983463
Slovakia,1996,672,566,106,5032436,13.353373992237556
Slovakia,1997,630,524,106,5058389,12.45455816071085
Slovakia,1998,673,585,88,5081100,13.2451634488595
Slovakia,1999,692,590,102,5098200,13.573418069122436
Slovakia,2000,729,594,135,5111813,14.26108505925393
Slovakia,2001,692,580,112,5100256,13.567946393279083
Slovakia,2002,717,617,100,5107584,14.037948274565823
Slovakia,2003,753,648,105,5113982,14.724338098960848
Slovakia,2004,676,564,112,5121210,13.200005467457887
Slovakia,2005,679,584,95,5126946,13.24375173836432
Slovakia,2006,0,0,0,5129369,0.0
Slovakia,2007,0,0,0,5132660,0.0
Slovakia,2008,591,508,83,5137067,11.504619270101013
Slovakia,2009,601,543,58,5141744,11.688641052530036
Slovakia,2010,631,539,92,5147562,12.25823020684355
Slovakia,2012,571,499,72,5116922,11.159052258369387
Slovakia,2013,616,533,83,5122209,12.02606141217588
Slovakia,2014,554,471,83,5129686,10.799881318271723
Slovenia,1995,564,435,129,1884000,29.936305732484076
Slovenia,1996,607,465,142,1893100,32.06381068089377
Slovenia,1997,593,473,120,1883900,31.47725463134986
Slovenia,1998,612,477,135,1880300,32.54799765994788
Slovenia,1999,590,453,137,1884400,31.30970070048822
Slovenia,2000,588,433,155,1886483,31.169112046066672
Slovenia,2001,581,459,122,1901330,30.55755707846613
Slovenia,2002,540,433,107,1906124,28.329741401923485
Slovenia,2003,562,440,122,1907589,29.461272842315612
Slovenia,2004,512,370,142,1907862,26.836322543244744
Slovenia,2005,503,391,112,1911817,26.310049549721548
Slovenia,2006,529,415,114,1918570,27.572619190334468
Slovenia,2007,434,335,99,1927332,22.51817538441742
Slovenia,2008,408,324,84,1943758,20.990267306938414
Slovenia,2009,447,350,97,1942037,23.017069190751773
Slovenia,2010,414,336,78,1944774,21.287820589950297
Slovenia,2011,435,347,88,1944561,22.370087644460625
Slovenia,2012,440,360,80,1945988,22.610622470436613
Slovenia,2013,446,360,86,1948276,22.89203377755513
Slovenia,2014,388,325,63,1951786,19.879228562967455
Slovenia,2015,422,332,90,1954632,21.589741700739577
South Africa,1996,143,113,30,37773652,0.37857075614505054
South Africa,1997,104,82,22,38528157,0.269932454853732
South Africa,1998,180,137,43,39232468,0.45880366231357156
South Africa,1999,279,219,60,39907560,0.6991156562816669
South Africa,2000,267,209,58,40568559,0.6581451414135759
South Africa,2001,384,312,72,41185599,0.932364732633851
South Africa,2002,236,189,47,41803868,0.5645410611286017
South Africa,2003,256,193,63,42415309,0.6035556643003591
South Africa,2004,383,294,89,43005874,0.8905760175923876
South Africa,2005,458,357,101,43566107,1.051275937967099
South Africa,2006,514,417,97,44079057,1.1660866519898554
South Africa,2007,417,313,104,44577435,0.9354508620785382
South Africa,2008,441,346,95,43680586,1.0096018400485745
South Africa,2009,372,280,92,45607048,0.8156634036037588
South Africa,2010,393,299,94,46176200,0.8510877898138002
South Africa,2011,358,283,75,46806739,0.7648471302390879
South Africa,2012,487,373,114,47484256,1.0256030967401069
South Africa,2013,587,467,120,48192699,1.2180268218636188
South Africa,2014,580,459,121,48912129,1.185799947493596
South Africa,2015,482,377,105,49627460,0.9712364888309818
Spain,1985,2514,1829,685,35997000,6.983915326277189
Spain,1986,2755,2032,723,36223000,7.6056649090356965
Spain,1987,2804,2017,787,36425700,7.697861674586898
Spain,1988,2960,2150,810,36597300,8.088028351818304
Spain,1989,2987,2213,774,36740400,8.13001491546091
Spain,1990,2939,2135,804,36861400,7.973110082633866
Spain,1991,2916,2139,777,36958100,7.890015991081793
Spain,1992,2786,2104,682,37000900,7.529546578596737
Spain,1993,3037,2283,754,37122100,8.181110443644082
Spain,1994,3171,2429,742,37203100,8.523483258115588
Spain,1995,3157,2408,749,37275300,8.469415403766032
Spain,1996,3320,2451,869,37341200,8.890983685580538
Spain,1997,3373,2526,847,37405000,9.017511027937442
Spain,1998,3261,2499,762,37458900,8.705541273235466
Spain,1999,3220,2411,809,37789271,8.52093706703154
Spain,2000,3394,2575,819,38319996,8.856994661481698
Spain,2001,3189,2430,759,38713504,8.237435702022735
Spain,2002,3372,2555,817,39340611,8.571295448359965
Spain,2003,3478,2650,828,39947556,8.70641498068117
Spain,2004,3508,2651,857,40555823,8.64980597237541
Spain,2005,3399,2570,829,41195479,8.250905396682
Spain,2006,3247,2512,735,41808848,7.766298655251156
Spain,2007,3264,2463,801,42547327,7.671457245716048
Spain,2008,3457,2676,781,43199484,8.00241039916125
Spain,2009,3429,2666,763,43490086,7.884555574344001
Spain,2010,3158,2468,690,43595356,7.243890840116089
Spain,2011,3180,2435,745,43642571,7.2864634853890715
Spain,2012,3539,2724,815,44318859,7.985313881839782
Spain,2013,3873,2913,960,44227625,8.756970332456243
Spain,2014,3911,2938,973,44172771,8.85387063446846
Spain,2015,3604,2681,923,44186528,8.156332174367718
Sri Lanka,1985,5668,3938,1730,13857000,40.903514469221335
Sri Lanka,1986,5345,3854,1491,14101400,37.9040378969464
Sri Lanka,1996,4898,3728,1170,16654427,29.40959782044738
Sri Lanka,1997,5887,4390,1497,16775409,35.093034095323695
Sri Lanka,1998,5518,4206,1312,16897691,32.655349183506786
Sri Lanka,1999,5619,4271,1348,17020287,33.013544366202524
Sri Lanka,2000,5252,3959,1293,17140342,30.641162235852704
Sri Lanka,2001,4590,3582,1008,17266961,26.582558447893643
Sri Lanka,2002,4382,3465,917,17395955,25.18976394224979
Sri Lanka,2003,4467,3533,934,17524596,25.489888611412212
Sri Lanka,2006,4015,3117,898,17891558,22.44075110730994
Suriname,1985,80,58,22,322700,24.79082739386427
Suriname,1986,42,30,12,326294,12.871827247819452
Suriname,1987,52,40,12,332013,15.66203732986359
Suriname,1988,49,32,17,339611,14.428272346891003
Suriname,1989,53,41,12,347723,15.242017352892962
Suriname,1990,26,22,4,348700,7.456266131344996
Suriname,1991,57,35,22,363079,15.6990627384123
Suriname,1992,48,35,13,370194,12.96617449229323
Suriname,1995,55,42,13,389414,14.12378599639458
Suriname,1996,21,17,4,395805,5.305642930230796
Suriname,1997,32,21,11,401814,7.963883787025837
Suriname,1998,29,21,8,407606,7.114713718640059
Suriname,1999,49,34,15,413303,11.855708765723936
Suriname,2000,52,38,14,419001,12.410471574053522
Suriname,2001,72,56,16,424515,16.960531429984805
Suriname,2002,69,48,21,430176,16.03994644052667
Suriname,2003,77,58,19,435946,17.66273804553775
Suriname,2004,67,49,18,441717,15.168082731703784
Suriname,2005,72,60,12,447445,16.091363184301983
Suriname,2006,112,84,28,453293,24.708080645410362
Suriname,2007,119,87,32,459086,25.92106925499797
Suriname,2008,147,113,34,464789,31.627254517641337
Suriname,2009,131,99,32,470448,27.84579804781825
Suriname,2010,136,94,42,476052,28.56830766386865
Suriname,2011,127,95,32,481521,26.374758317913443
Suriname,2012,133,100,33,486964,27.312080564477046
Suriname,2013,131,97,34,492359,26.606602093188098
Suriname,2014,128,92,36,497701,25.71825252511046
Sweden,1987,1541,1077,464,7909000,19.484132001517256
Sweden,1988,1590,1098,492,7930900,20.04816603411971
Sweden,1989,1579,1122,457,7964800,19.8247288067497
Sweden,1990,1471,1020,451,8005700,18.37440823413318
Sweden,1991,1483,1036,447,8041100,18.442750369974256
Sweden,1992,1355,936,419,8073200,16.783927067333895
Sweden,1993,1373,956,417,8112500,16.924499229583976
Sweden,1994,1324,929,395,8174100,16.197501865648817
Sweden,1995,1348,936,412,8233000,16.373132515486457
Sweden,1996,1253,872,381,8274300,15.143274959815331
Sweden,1997,1201,857,344,8311300,14.450206345577708
Sweden,1998,1231,882,349,8346300,14.749050477457075
Sweden,1999,1220,862,358,8378013,14.56192536344835
Sweden,2000,1131,802,329,8409008,13.449862338102186
Sweden,2001,1197,833,364,8439317,14.18361225203414
Sweden,2002,1180,862,318,8465828,13.938388542739116
Sweden,2003,1112,776,336,8490539,13.096930595336763
Sweden,2004,1155,834,321,8514314,13.565391175378311
Sweden,2005,1219,835,384,8538624,14.276304940936619
Sweden,2006,1197,817,380,8576044,13.957484359921661
Sweden,2007,1126,801,325,8629159,13.048780304082936
Sweden,2008,1170,855,315,8688504,13.466069647893354
Sweden,2009,1242,888,354,8755922,14.184685519126369
Sweden,2010,1141,838,303,8823125,12.931926046610469
Sweden,2011,1112,789,323,8884644,12.515977004818652
Sweden,2012,1154,819,335,8948909,12.89542669391319
Sweden,2013,1230,862,368,9024081,13.63019680341965
Sweden,2014,1148,785,363,9114524,12.595281991687113
Sweden,2015,1182,851,331,9114524,12.968312991440913
Sweden,2016,1130,782,348,8125852,13.906234078592618
Switzerland,1995,1419,1018,401,6617500,21.443143180959577
Switzerland,1996,1432,1010,422,6652200,21.52671296713869
Switzerland,1997,1341,963,378,6675200,20.089285714285715
Switzerland,1998,1371,1009,362,6725167,20.386110857916243
Switzerland,1999,1296,929,367,6764328,19.15933112646223
Switzerland,2000,1380,981,399,6809589,20.26554025507266
Switzerland,2001,1338,945,393,6865842,19.48777731849932
Switzerland,2002,1446,980,466,6942010,20.829702060354276
Switzerland,2003,1269,848,421,6969293,18.20844668175093
Switzerland,2004,1284,857,427,7023166,18.2823530014811
Switzerland,2005,1299,899,400,7071991,18.368236045549267
Switzerland,2006,1309,863,446,7118477,18.38876490013243
Switzerland,2007,1360,920,440,7183595,18.932024981920613
Switzerland,2008,1314,861,453,7274875,18.062166016598223
Switzerland,2009,1105,827,278,7364558,15.004294894547643
Switzerland,2010,1006,724,282,7439147,13.523055801962242
Switzerland,2011,1034,757,277,7518040,13.753584710908694
Switzerland,2012,1038,752,286,7595591,13.66582271214972
Switzerland,2013,1071,786,285,7681318,13.942919691646669
Switzerland,2014,1032,756,276,7809621,13.214469690654642
Switzerland,2015,1073,793,280,7892502,13.59518185741353
Thailand,1985,2982,1742,1240,46303443,6.440125845501382
Thailand,1986,2798,1774,1024,47331465,5.911500943399914
Thailand,1987,3035,1855,1180,48376410,6.273718946899946
Thailand,1990,3753,2439,1314,51228668,7.325976150697496
Thailand,1991,3559,2402,1157,51947693,6.851122339542585
Thailand,1992,3550,2359,1191,52570440,6.752844374138775
Thailand,1994,2307,1612,695,52691000,4.378356835133135
Thailand,1995,4245,3100,1145,54366057,7.808180755135506
Thailand,1996,4443,3300,1143,55070703,8.067810574344765
Thailand,1997,4150,3196,954,55859088,7.429408800945694
Thailand,1998,4963,3842,1121,56691783,8.754355106453435
Thailand,1999,5276,4068,1208,57507860,9.174398073585072
Thailand,2000,5182,4033,1149,58262135,8.894284426755044
Thailand,2002,4902,3712,1190,58263389,8.41351676264489
Thailand,2003,4484,3425,1059,60158951,7.453587413783196
Thailand,2004,4296,3253,1043,60686373,7.07901920584379
Thailand,2005,3937,3030,907,61182665,6.434829211836393
Thailand,2006,3608,2852,756,61636512,5.853673225376543
Thailand,2007,3754,2943,811,58941621,6.369013841679041
Thailand,2008,3778,2906,872,59216773,6.379949140423441
Thailand,2009,3787,2926,861,59483718,6.366448042134825
Thailand,2010,3761,2913,848,59769764,6.292479254226268
Thailand,2011,3873,2985,888,60261832,6.426953631280244
Thailand,2012,3985,3055,930,60382255,6.59962103104629
Thailand,2013,3961,3105,856,60766487,6.5183955755085865
Thailand,2014,3952,3074,878,61139919,6.463862014602931
Thailand,2015,4205,3366,839,61261276,6.864042466239195
Thailand,2016,4117,3275,842,53442001,7.703678610387362
Trinidad and Tobago,1985,29,24,5,1008000,2.876984126984127
Trinidad and Tobago,1986,104,69,35,1061600,9.796533534287867
Trinidad and Tobago,1987,119,92,27,1078300,11.035889826578874
Trinidad and Tobago,1988,164,118,46,1095600,14.968966776195693
Trinidad and Tobago,1989,173,132,41,1070000,16.168224299065418
Trinidad and Tobago,1990,170,125,45,1088500,15.617822691777675
Trinidad and Tobago,1991,148,118,30,1102000,13.430127041742285
Trinidad and Tobago,1992,163,137,26,1132600,14.391665195126256
Trinidad and Tobago,1993,174,148,26,1148300,15.152834625097972
Trinidad and Tobago,1994,148,118,30,1162900,12.726803680454037
Trinidad and Tobago,1995,184,145,39,1149173,16.011514367288477
Trinidad and Tobago,1996,146,111,35,1156185,12.627736910615518
Trinidad and Tobago,1997,160,129,31,1162267,13.766200021165533
Trinidad and Tobago,1998,171,141,30,1167924,14.64136365037451
Trinidad and Tobago,1999,139,109,30,1173276,11.847169804888193
Trinidad and Tobago,2000,166,134,32,1178363,14.087339809549349
Trinidad and Tobago,2001,179,141,38,1183354,15.126496382316702
Trinidad and Tobago,2002,156,129,27,1188800,13.122476446837146
Trinidad and Tobago,2003,144,109,35,1194458,12.055677135571113
Trinidad and Tobago,2004,168,143,25,1200116,13.998646797476244
Trinidad and Tobago,2005,136,110,26,1205471,11.281897283302543
Trinidad and Tobago,2006,141,115,26,1209301,11.659628165361642
Trinidad and Tobago,2007,131,111,20,1213988,10.790880964226995
Trinidad and Tobago,2008,199,163,36,1219336,16.32035796531883
Trinidad and Tobago,2009,128,107,21,1225097,10.448152268759127
Trinidad and Tobago,2010,160,129,31,1231002,12.99754183989953
Trinidad and Tobago,2011,139,112,27,1237186,11.235174015871502
Turkey,2009,1050,801,249,65962419,1.5918154851173665
Turkey,2010,1524,1148,376,66975131,2.2754714731353043
Turkey,2011,1148,850,298,68034357,1.6873827439862479
Turkey,2012,1450,1072,378,68976439,2.102167089257826
Turkey,2013,1810,1347,463,69880352,2.590141503580291
Turkey,2014,1617,1209,408,70931420,2.279666754169027
Turkey,2015,1532,1135,397,71880464,2.131316236355959
Turkmenistan,1987,272,175,97,2859100,9.513483263964185
Turkmenistan,1988,270,186,84,2926300,9.226668489218467
Turkmenistan,1989,253,171,82,2999000,8.436145381793931
Turkmenistan,1990,298,216,82,3079800,9.675952983959997
Turkmenistan,1991,273,186,87,3162500,8.632411067193676
Turkmenistan,1992,271,191,80,3252900,8.331027698361462
Turkmenistan,1993,240,173,67,3331100,7.204827234246945
Turkmenistan,1994,234,165,69,3423100,6.835908971400193
Turkmenistan,1995,244,192,52,3818200,6.3904457597820965
Turkmenistan,1996,283,230,53,3913000,7.23230258113979
Turkmenistan,1997,333,261,72,4006400,8.31170127795527
Turkmenistan,1998,405,322,83,4099200,9.879976580796253
Turkmenistan,1999,442,342,100,3958754,11.165129230055719
Turkmenistan,2000,383,307,76,4026478,9.512035083763031
Turkmenistan,2001,445,367,78,4095981,10.864308208460928
Turkmenistan,2002,416,336,80,4143692,10.039356206976773
Turkmenistan,2003,377,295,82,4177740,9.024017770373456
Turkmenistan,2004,392,299,93,4211000,9.308952742816434
Turkmenistan,2005,468,374,94,4252530,11.005213367101467
Turkmenistan,2006,506,392,114,4287650,11.801336396394294
Turkmenistan,2007,354,269,85,4342657,8.151691464465188
Turkmenistan,2008,484,370,114,4412135,10.96974593932416
Turkmenistan,2009,165,125,40,4484467,3.6793670239963854
Turkmenistan,2010,178,131,47,4551185,3.9110693149146867
Turkmenistan,2011,130,91,39,4626095,2.8101454898786122
Turkmenistan,2012,138,105,33,4690058,2.9423943158059025
Turkmenistan,2013,101,73,28,4748055,2.127186816496439
Turkmenistan,2014,136,92,44,4811227,2.8267217489426297
Turkmenistan,2015,133,92,41,4886514,2.72177671035016
Ukraine,1987,10050,7457,2593,47374200,21.214078549083677
Ukraine,1988,9751,7243,2508,47549900,20.506878037598398
Ukraine,1989,10887,8296,2591,47761700,22.794414771668514
Ukraine,1990,10645,8229,2416,47971600,22.190212542420934
Ukraine,1991,10700,8338,2362,48200600,22.198893789703863
Ukraine,1992,11666,9128,2538,48487300,24.05990847087794
Ukraine,1993,12469,9864,2605,48680500,25.613952198518913
Ukraine,1994,13826,11063,2763,48619000,28.43744215224501
Ukraine,1995,14541,11909,2632,48415300,30.03389424417488
Ukraine,1996,15160,12495,2665,48174500,31.468930658335843
Ukraine,1997,14903,12110,2793,47923000,31.097802725205018
Ukraine,1998,14789,11948,2841,47675400,31.020190706318143
Ukraine,1999,14363,11726,2637,47415400,30.29184610907005
Ukraine,2000,14467,11834,2633,47125400,30.698943669443654
Ukraine,2001,13131,10939,2192,46805969,28.05411420923686
Ukraine,2002,12536,10367,2169,46060017,27.216663858374172
Ukraine,2003,12313,10163,2150,45697383,26.944650200209495
Ukraine,2004,11256,9391,1865,45322826,24.835168045346514
Ukraine,2005,10621,8860,1761,44939270,23.634117777169056
Ukraine,2006,10013,8300,1713,44560034,22.47080870719264
Ukraine,2007,10032,8403,1629,44198672,22.697514531658324
Ukraine,2008,9454,7779,1675,43856123,21.556853076137166
Ukraine,2009,9715,7991,1724,43557944,22.30362388087004
Ukraine,2010,9089,7510,1579,43296809,20.992309156085845
Ukraine,2011,8973,7309,1664,43074791,20.83120960470824
Ukraine,2012,9058,7361,1697,42915935,21.106379250504503
Ukraine,2014,7968,6412,1556,40464165,19.691497402701874
Ukraine,2015,7574,6148,1426,40345446,18.772874638689085
United Arab Emirates,2005,96,80,16,4280433,2.2427637577787105
United Arab Emirates,2006,90,76,14,4923879,1.8278272069642654
United Arab Emirates,2007,101,88,13,5695389,1.7733643830122932
United Arab Emirates,2008,100,82,18,6510358,1.536013841327927
United Arab Emirates,2009,124,109,15,7252480,1.7097599717613836
United Arab Emirates,2010,111,89,22,7839736,1.4158640035837942
United Kingdom,1985,5105,3421,1684,53006535,9.630887965040538
United Kingdom,1986,4839,3391,1448,53119533,9.109643339673186
United Kingdom,1987,4594,3263,1331,53239668,8.62890429744979
United Kingdom,1988,4971,3611,1360,53310780,9.324568126746598
United Kingdom,1989,4361,3234,1127,53425129,8.162825400009798
United Kingdom,1990,4643,3524,1119,53557854,8.669130021527748
United Kingdom,1991,4547,3494,1053,53903427,8.43545624659449
United Kingdom,1992,4628,3557,1071,54076358,8.558268661510082
United Kingdom,1993,4462,3433,1029,54283982,8.219735980311834
United Kingdom,1994,4380,3390,990,54497293,8.037096448074953
United Kingdom,1995,4315,3354,961,54746964,7.881715596137897
United Kingdom,1996,4165,3185,980,55012207,7.57104691327872
United Kingdom,1997,4143,3197,946,55266635,7.496385477422319
United Kingdom,1998,4389,3407,982,55527379,7.904208840831474
United Kingdom,1999,4448,3443,1005,55833339,7.966566355632072
United Kingdom,2000,4290,3311,979,56133909,7.642439438878201
United Kingdom,2001,4128,3199,929,55571993,7.4282021881057965
United Kingdom,2002,4117,3164,953,55908944,7.363759186723327
United Kingdom,2003,3979,3050,929,56171771,7.083629248577546
United Kingdom,2004,4183,3162,1021,56455011,7.409439704121216
United Kingdom,2005,4047,3054,993,56809024,7.123868207980479
United Kingdom,2006,4122,3186,936,57091129,7.220035883333118
United Kingdom,2007,3897,3025,872,57382757,6.79123869910956
United Kingdom,2008,4259,3300,959,57683372,7.383410248624162
United Kingdom,2009,4246,3313,933,58013559,7.318978654627964
United Kingdom,2010,4188,3225,963,58403529,7.170799559047194
United Kingdom,2011,4393,3433,960,58881852,7.460702832512809
United Kingdom,2012,4444,3512,932,59708630,7.442810193434349
United Kingdom,2013,4824,3831,993,60091793,8.027718527220514
United Kingdom,2014,4788,3717,1071,60570482,7.9048405129085815
United Kingdom,2015,4910,3732,1178,61082942,8.038250678888389
United States,1985,29446,23138,6308,220723000,13.340703053148063
United States,1986,30892,24215,6677,222953000,13.85583508631864
United States,1987,30783,24261,6522,225148000,13.672339971929574
United States,1988,30388,24061,6327,227353000,13.3659991291076
United States,1989,30218,24090,6128,229487000,13.167630410437193
United States,1990,30895,24716,6179,229952200,13.435400922452578
United States,1991,30790,24752,6038,232955000,13.21714494215621
United States,1992,30471,24448,6023,235565600,12.935250308194405
United States,1993,31084,24992,6092,238092300,13.055441104143224
United States,1994,31123,25157,5966,240614100,12.934819696767562
United States,1995,31272,25358,5914,243164200,12.860445739956786
United States,1996,30879,24980,5899,245997800,12.552551282978953
United States,1997,30517,24476,6041,248486400,12.281155024983258
United States,1998,30558,24521,6037,251332500,12.15839575064904
United States,1999,29183,23442,5741,253748671,11.500749889641787
United States,2000,29343,23611,5732,262246108,11.189107904701489
United States,2001,30607,24658,5949,265427546,11.53120708880758
United States,2002,31645,25399,6246,268759559,11.774464922380677
United States,2003,31477,25196,6281,271041510,11.61335029457296
United States,2004,32428,25555,6873,273584136,11.853026448872752
United States,2005,32629,25900,6729,276106680,11.817533715591379
United States,2006,33292,26300,6992,278980848,11.933435660070831
United States,2007,34596,27267,7329,280658606,12.326719815604015
United States,2008,36030,28447,7583,282355565,12.76050642033565
United States,2009,36900,29079,7821,285162662,12.939983005208445
United States,2010,38362,30275,8087,287839149,13.32758248253437
United States,2011,39508,30996,8512,290313825,13.608721527471179
United States,2012,40596,31777,8819,292827128,13.863469644110294
United States,2013,41143,32049,9094,295322862,13.931532330876571
United States,2014,42769,33110,9659,297749735,14.364076596071529
United States,2015,44189,33990,10199,300078511,14.72581287235193
Uruguay,1985,287,236,51,2737400,10.48440125666691
Uruguay,1986,262,205,57,2757600,9.501015375689004
Uruguay,1987,258,192,66,2778900,9.28424916333801
Uruguay,1988,268,212,56,2799600,9.572796113730533
Uruguay,1989,344,276,68,2820700,12.195554295033148
Uruguay,1990,315,249,66,2834000,11.115031757233591
Uruguay,1993,418,319,99,2896228,14.432565391951185
Uruguay,1994,406,328,78,2920296,13.902700274218779
Uruguay,1995,427,324,103,2943816,14.504982648372046
Uruguay,1996,393,307,86,2967278,13.244461759228491
Uruguay,1997,456,366,90,2991662,15.242363609257998
Uruguay,1998,521,415,106,3014887,17.28091301597705
Uruguay,1999,450,366,84,3034833,14.827834019203035
Uruguay,2000,555,461,94,3050169,18.195713089995994
Uruguay,2001,499,390,109,3061024,16.3017343215865
Uruguay,2002,675,534,141,3065257,22.020992040797882
Uruguay,2003,535,412,123,3065772,17.450743238570904
Uruguay,2004,520,412,108,3066489,16.957504168448022
Uruguay,2005,498,383,115,3070178,16.2205578959917
Uruguay,2006,528,392,136,3077445,17.15708972865478
Uruguay,2007,576,441,135,3087957,18.65310948306599
Uruguay,2008,523,411,112,3100791,16.86666402218015
Uruguay,2009,511,408,103,3114306,16.408150001958703
Uruguay,2010,547,421,126,3127306,17.491092972673606
Uruguay,2012,599,476,123,3151939,19.004174890440456
Uruguay,2013,546,423,123,3164670,17.252983723421398
Uruguay,2014,591,460,131,3177645,18.598679210547434
Uruguay,2015,630,499,131,3190795,19.74429570060126
Uzbekistan,1990,1459,1008,451,17165700,8.499507739270756
Uzbekistan,1991,1393,1039,354,17347800,8.029836636345818
Uzbekistan,1992,1344,996,348,18257000,7.3615599496083695
Uzbekistan,1993,1355,1005,350,18509300,7.320644216691068
Uzbekistan,1994,1419,1077,342,19144700,7.411973026477302
Uzbekistan,1995,1485,1154,331,19599000,7.576917189652534
Uzbekistan,1996,1699,1332,367,19854500,8.557254023017451
Uzbekistan,1997,1554,1206,348,20364300,7.631001311117986
Uzbekistan,1998,1620,1252,368,20861200,7.765612716430502
Uzbekistan,1999,1795,1375,420,21329916,8.41541054357645
Uzbekistan,2000,1919,1455,464,21789067,8.807169210136442
Uzbekistan,2001,1914,1462,452,22231527,8.609395117123533
Uzbekistan,2002,1576,1177,399,22632256,6.963512607846076
Uzbekistan,2003,1416,1037,379,22982883,6.161106942066407
Uzbekistan,2004,1251,943,308,23300841,5.368904924933825
Uzbekistan,2005,1221,921,300,23600347,5.17365274332619
Uzbekistan,2009,1399,1023,376,25288102,5.532245955034506
Uzbekistan,2010,1464,1011,453,25651783,5.707205616077448
Uzbekistan,2011,1640,1123,517,25978049,6.3130221980873165
Uzbekistan,2012,1835,1220,615,26381830,6.95554478214741
Uzbekistan,2013,1950,1322,628,26838924,7.265566980255989
Uzbekistan,2014,2095,1405,690,27313507,7.670197752342824
